University Name,state,state_code,type,degree_length,room_and_board,in_state_tuition,in_state_total,out_of_state_tuition,out_of_state_total,early_career_pay,mid_career_pay,american indian / alaska native,black,hispanic,native hawaiian / pacific islander,asian,two or more races,other,total enrollment
Adams State University,Colorado,CO,Public,Public,4 Year,8782,9440,18222,20456,44400,81400,37,191,812,10,37,126,1941,3154
Agnes Scott College,Georgia,GA,Private,Private,4 Year,12330,41160,53490,41160,46000,83600,1,288,78,2,41,52,411,873
Alabama State University,Alabama,AL,Public,Public,4 Year,5422,11068,16490,19396,39800,71500,8,4950,68,3,20,56,414,5519
Alaska Pacific University,Alaska,AK,Private,Private,4 Year,7300,20830,28130,20830,50300,90000,87,13,15,4,10,41,409,579
Albany College of Pharmacy and Health Sciences,New York,NY,Private,Private,4 Year,10920,35105,46025,35105,81000,144800,4,59,63,2,228,16,1191,1563
Albertus Magnus College,Connecticut,CT,Private,Private,4 Year,13200,32060,45260,32060,49700,85900,6,515,217,2,7,20,783,1550
Albion College,Michigan,MI,Private,Private,4 Year,12380,45775,58155,45775,52100,99300,3,47,46,1,23,33,1115,1268
Alcorn State University,Mississippi,MS,Public,Public,4 Year,9608,7144,16752,7144,40900,69500,3,3386,12,11,10,57,160,3639
Allen College,Iowa,IA,Private,Private,4 Year,7282,19970,27252,19970,51600,91300,0,13,2,2,7,5,546,575
Alma College,Michigan,MI,Private,Private,4 Year,10998,40258,51256,40258,48400,89900,9,46,51,1,21,36,1232,1396
Amherst College,Massachusetts,MA,Private,Private,4 Year,14740,56426,71166,56426,63800,116500,6,222,235,1,234,81,1013,1792
Andrews University,Michigan,MI,Private,Private,4 Year,9078,29288,38366,29288,47600,85000,10,702,458,13,315,71,1849,3418
Appalachian State University,North Carolina,NC,Public,Public,4 Year,8304,7214,15518,22021,46600,82700,44,584,702,11,267,441,15977,18026
Arizona Christian University,Arizona,AZ,Private,Private,4 Year,10674,26796,37470,26796,42600,76600,7,55,114,5,18,34,504,737
Arkansas Tech University,Arkansas,AR,Public,Public,4 Year,7870,9068,16938,15848,45000,76900,121,919,728,8,154,309,9763,12002
Asbury University,Kentucky,KY,Private,Private,4 Year,7160,30198,37358,30198,39400,70800,4,92,40,5,14,99,1625,1879
Auburn University,Alabama,AL,Public,Public,4 Year,13332,11276,24608,30524,54400,104500,183,1886,599,0,601,0,22643,25912
Auburn University at Montgomery,Alabama,AL,Public,Public,4 Year,6980,10288,17268,22048,45000,79600,23,1633,36,9,104,136,3116,5057
Augusta University,Georgia,GA,Public,Public,4 Year,9640,10758,20398,29796,47000,84400,25,1687,398,22,500,328,5028,7988
Austin Peay State University,Tennessee,TN,Public,Public,4 Year,10700,8411,19111,24467,44200,78200,40,1902,575,19,157,514,6904,10111
Avila University,Missouri,MO,Private,Private,4 Year,7200,19900,27100,19900,45900,81200,14,359,125,5,31,43,1330,1907
Babson College,Massachusetts,MA,Private,Private,4 Year,16312,51104,67416,51104,72000,133800,4,119,244,2,274,58,2348,3049
Baker University,Kansas,KS,Private,Private,4 Year,8410,29830,38240,29830,47800,84200,54,281,147,11,43,39,2382,2957
Ball State University,Indiana,IN,Public,Public,4 Year,10234,9896,20130,26468,45600,83700,26,1378,692,24,215,411,17909,20655
Barnard College,New York,NY,Private,Private,4 Year,17225,55032,72257,55032,59200,109800,1,168,286,1,367,133,1617,2573
Barry University,Florida,FL,Private,Private,4 Year,11100,29850,40950,29850,47400,84400,28,2090,2032,12,182,87,4087,8518
Barton College,North Carolina,NC,Private,Private,4 Year,10120,30880,41000,30880,42400,77900,9,245,55,0,12,28,686,1035
Bastyr University,Washington,WA,Private,Private,4 Year,7590,26166,33756,26166,48400,86300,6,43,42,0,121,73,917,1202
Bates College,Maine,ME,Private,Private,4 Year,15224,53794,69018,53794,59500,111900,4,85,120,0,82,72,1410,1773
Baylor University,Texas,TX,Private,Private,4 Year,12595,45727,58322,45727,55500,101400,62,1129,2146,9,939,699,11279,16263
Belhaven University,Mississippi,MS,Private,Private,4 Year,8500,25300,33800,25300,41200,74300,23,2253,144,7,20,61,1606,4114
Bellarmine University,Kentucky,KY,Private,Private,4 Year,12250,42200,54450,42200,49000,90700,9,196,101,5,65,97,3136,3609
Bellevue University,Nebraska,NE,Private,Private,4 Year,8730,9390,18120,9390,49400,84800,49,1168,676,30,214,211,7531,9879
Belmont Abbey College,North Carolina,NC,Private,Private,4 Year,10355,18500,28855,18500,46700,82900,4,391,23,0,15,5,1122,1560
Belmont University,Tennessee,TN,Private,Private,4 Year,12120,34310,46430,34310,47300,80900,16,318,300,7,157,231,6215,7244
Beloit College,Wisconsin,WI,Private,Private,4 Year,8830,50040,58870,50040,47400,85700,5,60,109,3,32,22,1072,1303
Benedict College,South Carolina,SC,Private,Private,4 Year,6200,16600,22800,16600,38100,67500,0,2416,7,0,9,0,12,2444
Benedictine College,Kansas,KS,Private,Private,4 Year,10300,29530,39830,29530,48700,91800,8,70,112,7,26,95,1820,2138
Bennington College,Vermont,VT,Private,Private,4 Year,15610,54360,69970,54360,48800,90000,13,10,38,1,25,23,645,755
Bentley University,Massachusetts,MA,Private,Private,4 Year,16320,49880,66200,49880,66600,116600,4,149,325,0,433,102,4552,5565
Berea College,Kentucky,KY,Private,Private,4 Year,6764,39990,46754,39990,39500,71600,2,242,95,3,26,88,1165,1621
Berry College,Georgia,GA,Private,Private,4 Year,12770,36556,49326,36556,44900,84900,2,93,134,3,26,62,1857,2177
Black Hills State University,South Dakota,SD,Public,Public,4 Year,6978,8733,15711,11778,40400,72600,154,41,166,10,22,143,3953,4489
Bloomfield College,New Jersey,NJ,Private,Private,4 Year,11950,29550,41500,29550,48400,89100,12,1044,484,8,56,11,389,2004
Boise State University,Idaho,ID,Public,Public,4 Year,10692,7694,18386,23776,50100,86400,132,357,2149,71,436,697,18385,22227
Boston College,Massachusetts,MA,Private,Private,4 Year,14478,55464,69942,55464,63600,115400,15,575,1238,1,1144,375,10969,14317
Boston University,Massachusetts,MA,Private,Private,4 Year,15720,53948,69668,53948,61400,113600,27,1190,2419,34,3448,868,24126,32112
Bowdoin College,Maine,ME,Private,Private,4 Year,14698,53922,68620,53922,61300,112000,2,88,229,0,114,117,1255,1805
Bowie State University,Maryland,MD,Public,Public,4 Year,10904,8233,19137,18873,50300,89900,6,4751,147,9,81,168,533,5695
Bradley University,Illinois,IL,Private,Private,4 Year,10620,33760,44380,33760,55600,104900,10,245,282,5,144,69,4545,5300
Brandeis University,Massachusetts,MA,Private,Private,4 Year,15440,55395,70835,55395,60600,113200,6,275,323,3,582,118,4638,5945
Brescia University,Kentucky,KY,Private,Private,4 Year,9200,22400,31600,22400,44300,81200,9,133,63,2,3,0,846,1056
Brown University,Rhode Island,RI,Private,Private,4 Year,14670,55656,70326,55656,68200,127600,26,550,894,13,1099,376,6223,9181
Bryant University,Rhode Island,RI,Private,Private,4 Year,15702,43973,59675,43973,60500,108600,12,145,216,5,141,44,2899,3462
Bucknell University,Pennsylvania,PA,Private,Private,4 Year,13662,56092,69754,56092,66700,122900,1,114,187,0,126,124,3072,3624
Butler University,Indiana,IN,Private,Private,4 Year,13830,41120,54950,41120,51800,99300,8,182,146,0,119,91,4302,4848
California Institute of Technology,California,CA,Private,Private,4 Year,15525,52362,67887,52362,84100,151600,4,27,173,1,580,68,1356,2209
Calvin College,Michigan,MI,Private,Private,4 Year,10200,34600,44800,34600,50200,91100,16,94,129,0,173,111,3470,3993
Cameron University,Oklahoma,OK,Public,Public,4 Year,5452,6450,11902,15870,43900,81500,296,861,644,36,93,427,3180,5537
Campbell University,North Carolina,NC,Private,Private,4 Year,11430,32500,43930,32500,46300,82400,40,946,343,9,193,112,4458,6101
Campbellsville University,Kentucky,KY,Private,Private,4 Year,8000,25400,33400,25400,37600,66800,6,375,56,4,17,41,2928,3427
Cardinal Stritch University,Wisconsin,WI,Private,Private,4 Year,8440,29998,38438,29998,47000,82500,18,842,293,8,76,71,2503,3811
Carleton College,Minnesota,MN,Private,Private,4 Year,14085,54759,68844,54759,58800,109900,3,79,130,2,184,93,1566,2057
Carnegie Mellon University,Pennsylvania,PA,Private,Private,4 Year,14418,55465,69883,55465,75900,136100,9,402,574,2,2071,334,9195,12587
Carroll College,Montana,MT,Private,Private,4 Year,9880,35486,45366,35486,48200,91400,18,11,71,4,21,23,1292,1440
Carroll University,Wisconsin,WI,Private,Private,4 Year,9484,31918,41402,31918,45600,86500,2,37,190,3,116,68,3030,3446
Carson-Newman University,Tennessee,TN,Private,Private,4 Year,8810,27900,36710,27900,42700,76500,3,153,34,0,13,0,2159,2362
Carthage College,Wisconsin,WI,Private,Private,4 Year,11990,43550,55540,43550,48900,85400,12,153,126,7,33,71,2546,2948
Case Western Reserve University,Ohio,OH,Private,Private,4 Year,15190,49042,64232,49042,66600,117800,14,563,444,5,1543,269,7933,10771
Catawba College,North Carolina,NC,Private,Private,4 Year,10488,30520,41008,30520,42500,78100,12,265,48,0,15,28,932,1300
Centenary College of Louisiana,Louisiana,LA,Private,Private,4 Year,13400,36580,49980,36580,47000,88400,6,88,35,1,21,22,446,619
Central Baptist College,Arkansas,AR,Private,Private,4 Year,7500,16200,23700,16200,36900,68000,12,175,33,1,2,12,623,858
Central Christian College of Kansas,Kansas,KS,Private,Private,4 Year,8286,26674,34960,26674,37100,66100,19,210,107,5,11,17,796,1165
Central College,Iowa,IA,Private,Private,4 Year,10280,37295,47575,37295,49000,88800,5,26,44,2,15,14,1305,1411
Central Connecticut State University,Connecticut,CT,Public,Public,4 Year,12176,10616,22792,21856,53100,93700,23,1225,1359,11,429,290,8700,12037
Central Michigan University,Michigan,MI,Public,Public,4 Year,10076,12960,23036,12960,47700,83600,181,3016,901,24,317,604,21836,26879
Central Washington University,Washington,WA,Public,Public,4 Year,11115,8072,19187,23053,52700,93200,65,365,1430,137,532,710,8560,11799
Centre College,Kentucky,KY,Private,Private,4 Year,10480,41700,52180,41700,49500,88500,0,64,32,2,46,42,1201,1387
Chadron State College,Nebraska,NE,Public,Public,4 Year,7380,7196,14576,7196,42300,76700,36,116,180,11,25,83,2582,3033
Chaminade University of Honolulu,Hawaii,HI,Private,Private,4 Year,13630,25374,39004,25374,45400,84000,24,152,162,429,726,265,998,2756
Champlain College,Vermont,VT,Private,Private,4 Year,15354,41010,56364,41010,51100,88400,15,97,137,2,54,203,3077,3585
Charleston Southern University,South Carolina,SC,Private,Private,4 Year,10200,25500,35700,25500,42800,76300,18,926,108,4,41,67,2203,3367
Christian Brothers University,Tennessee,TN,Private,Private,4 Year,7400,32820,40220,32820,51500,96500,5,522,99,1,84,39,917,1667
Christopher Newport University,Virginia,VA,Public,Public,4 Year,11460,14754,26214,27220,50800,87200,15,414,258,5,125,251,4153,5221
Claremont McKenna College,California,CA,Private,Private,4 Year,16705,54405,71110,54405,68500,125400,1,54,154,1,142,101,871,1324
Clark Atlanta University,Georgia,GA,Private,Private,4 Year,9524,23436,32960,23436,46300,81100,14,2930,14,0,14,0,513,3485
Clark University,Massachusetts,MA,Private,Private,4 Year,9170,45730,54900,45730,52600,101400,3,121,169,2,179,59,2890,3423
Clarke University,Iowa,IA,Private,Private,4 Year,9600,33350,42950,33350,44900,80200,1,33,44,0,9,16,1097,1200
Clarkson College,Nebraska,NE,Private,Private,4 Year,5398,16920,22318,16920,50900,91500,7,53,36,2,29,19,1075,1221
Clarkson University,New York,NY,Private,Private,4 Year,14908,49444,64352,49444,66400,130100,10,77,170,1,122,73,3420,3873
Cleary University,Michigan,MI,Private,Private,4 Year,9600,20250,29850,20250,47400,84700,0,41,12,0,14,0,470,537
Clemson University,South Carolina,SC,Public,Public,4 Year,10832,14970,25802,36724,57500,106700,41,1347,593,14,389,465,19008,21857
Cleveland State University,Ohio,OH,Public,Public,4 Year,13560,10625,24185,14992,48300,88600,26,2927,731,18,504,435,12295,16936
Coastal Carolina University,South Carolina,SC,Public,Public,4 Year,9190,11536,20726,26648,44700,77600,40,1904,348,13,77,405,7189,9976
Coe College,Iowa,IA,Private,Private,4 Year,9480,45000,54480,45000,47200,86900,3,71,109,1,33,45,1174,1436
Colby College,Maine,ME,Private,Private,4 Year,14190,55210,69400,55210,59200,103300,3,56,113,0,103,98,1474,1847
Colby-Sawyer College,New Hampshire,NH,Private,Private,4 Year,14264,42398,56662,42398,46400,83700,3,88,41,1,21,7,1208,1369
Colgate University,New York,NY,Private,Private,4 Year,13995,55870,69865,55870,68400,130600,2,120,243,3,103,101,2316,2888
College for Creative Studies,Michigan,MI,Private,Private,4 Year,8800,44110,52910,44110,51200,89800,3,130,54,4,61,54,1153,1459
College of Charleston,South Carolina,SC,Public,Public,4 Year,12166,12738,24904,31920,47300,85100,21,823,478,13,181,401,9539,11456
College of Saint Mary,Nebraska,NE,Private,Private,4 Year,7700,20350,28050,20350,43900,77700,5,63,102,1,17,25,805,1018
College of the Holy Cross,Massachusetts,MA,Private,Private,4 Year,14520,52770,67290,52770,61800,114600,5,110,296,1,141,98,2136,2787
Colorado Christian University,Colorado,CO,Private,Private,4 Year,11846,31866,43712,31866,46800,80100,36,391,623,16,157,227,4337,5787
Colorado College,Colorado,CO,Private,Private,4 Year,12512,55470,67982,55470,53100,97900,9,48,184,0,94,173,1559,2067
Colorado Mesa University,Colorado,CO,Public,Public,4 Year,10925,9243,20168,22440,47800,81500,68,218,1389,55,126,313,6947,9116
Colorado School of Mines,Colorado,CO,Public,Public,4 Year,13169,18964,32133,38584,75600,139600,13,52,417,3,231,244,5002,5962
Columbia International University,South Carolina,SC,Private,Private,4 Year,8150,23690,31840,23690,36600,66200,3,198,28,0,34,20,820,1103
Columbus State University,Georgia,GA,Public,Public,4 Year,9880,7200,17080,20682,43300,77900,35,2921,430,20,176,182,4428,8192
Connecticut College,Connecticut,CT,Private,Private,4 Year,15150,54820,69970,54820,57500,100800,0,62,163,0,67,52,1556,1900
Converse College,South Carolina,SC,Private,Private,4 Year,10930,18690,29620,18690,39000,71000,0,100,56,0,4,38,1191,1389
Corban University,Oregon,OR,Private,Private,4 Year,10228,33040,43268,33040,42500,77300,10,18,34,7,24,72,960,1125
Cornell College,Iowa,IA,Private,Private,4 Year,9384,42299,51683,42299,49600,90600,4,55,140,3,26,46,812,1086
Cornell University,New York,NY,Private,Private,4 Year,14816,55188,70004,55188,70100,128200,64,1059,1994,15,3129,762,14656,21679
Cornish College of the Arts,Washington,WA,Private,Private,4 Year,12400,41642,54042,41642,49000,86400,6,29,76,2,43,63,548,767
Covenant College,Georgia,GA,Private,Private,4 Year,10260,34330,44590,34330,44400,79400,4,32,34,2,22,23,1056,1173
Creighton University,Nebraska,NE,Private,Private,4 Year,11036,39916,50952,39916,53500,95800,36,330,472,25,742,259,6372,8236
Cumberland University,Tennessee,TN,Private,Private,4 Year,9290,22890,32180,22890,45500,81000,5,181,37,0,14,0,1244,1481
Dakota State University,South Dakota,SD,Public,Public,4 Year,6873,9276,16149,12249,48400,84300,25,144,115,6,61,75,2621,3047
Dakota Wesleyan University,South Dakota,SD,Private,Private,4 Year,7350,27300,34650,27300,41800,75700,9,15,23,0,2,18,803,870
Dartmouth College,New Hampshire,NH,Private,Private,4 Year,15756,55453,71209,55453,71500,130900,102,341,446,7,775,245,4382,6298
Davidson College,North Carolina,NC,Private,Private,4 Year,14372,51447,65819,51447,57300,106900,11,114,117,0,102,71,1355,1770
Delaware State University,Delaware,DE,Public,Public,4 Year,12190,7868,20058,16904,46300,81900,12,2916,226,5,47,160,1031,4397
Delta State University,Mississippi,MS,Public,Public,4 Year,7722,7246,14968,7246,40800,74200,4,1325,45,5,24,23,2188,3614
Denison University,Ohio,OH,Private,Private,4 Year,12710,51960,64670,51960,54400,104800,1,158,229,2,84,80,1724,2278
DePaul University,Illinois,IL,Private,Private,4 Year,14235,39975,54210,39975,55700,102900,19,2123,3388,37,1777,795,15660,23799
DePauw University,Indiana,IN,Private,Private,4 Year,13020,49704,62724,49704,56600,101000,6,126,76,0,75,144,1788,2215
Dickinson College,Pennsylvania,PA,Private,Private,4 Year,13698,54661,68359,54661,55800,100100,1,97,142,1,55,80,1988,2364
Dickinson State University,North Dakota,ND,Public,Public,4 Year,6898,6765,13663,9544,46400,81200,14,60,66,4,9,38,1288,1479
Dillard University,Louisiana,LA,Private,Private,4 Year,10100,18099,28199,18099,44700,79800,0,1108,6,0,0,9,77,1200
Dordt College,Iowa,IA,Private,Private,4 Year,9590,30870,40460,30870,51000,89600,3,22,12,103,13,0,1306,1459
Drake University,Iowa,IA,Private,Private,4 Year,10528,41396,51924,41396,52800,99900,10,160,163,1,200,79,4449,5062
Drew University,New Jersey,NJ,Private,Private,4 Year,14108,39500,53608,39500,52800,95000,4,249,204,2,105,52,1497,2113
Drexel University,Pennsylvania,PA,Private,Private,4 Year,14079,53279,67358,53279,61700,114800,40,2055,1424,108,3083,691,18958,26359
Drury University,Missouri,MO,Private,Private,4 Year,8096,28365,36461,28365,42600,79400,41,159,206,7,48,84,3670,4215
Duke University,North Carolina,NC,Private,Private,4 Year,15178,55695,70873,55695,71100,132100,66,1156,797,20,2268,369,11180,15856
East Carolina University,North Carolina,NC,Public,Public,4 Year,9606,7188,16794,23465,48400,85400,181,4359,1498,26,782,788,19877,27511
East Tennessee State University,Tennessee,TN,Public,Public,4 Year,8472,9277,17749,28459,43700,77300,38,860,290,9,232,341,12664,14434
Eastern Connecticut State University,Connecticut,CT,Public,Public,4 Year,13560,11356,24916,22596,49200,87800,16,346,482,6,151,137,4149,5287
Eastern Kentucky University,Kentucky,KY,Public,Public,4 Year,9018,9296,18314,19074,45600,80700,49,967,333,19,142,357,14438,16305
Eastern Michigan University,Michigan,MI,Public,Public,4 Year,9854,13959,23813,13959,47300,86700,52,4059,830,15,565,704,16176,22401
Eastern Oregon University,Oregon,OR,Public,Public,4 Year,10040,8679,18719,20739,44000,73900,83,99,229,36,77,47,3082,3653
Eastern Washington University,Washington,WA,Public,Public,4 Year,12793,7323,20116,24444,49500,87500,167,432,1772,37,395,604,10046,13453
Eckerd College,Florida,FL,Private,Private,4 Year,12588,44540,57128,44540,49200,88400,7,101,163,4,35,60,1713,2083
Edgewood College,Wisconsin,WI,Private,Private,4 Year,11020,29500,40520,29500,49500,87500,11,82,152,4,73,66,2592,2980
Elon University,North Carolina,NC,Private,Private,4 Year,12230,35319,47549,35319,53600,93700,29,391,316,3,146,110,5488,6483
Emory University,Georgia,GA,Private,Private,4 Year,14456,51306,65762,51306,62000,110800,26,1474,874,8,2281,338,9768,14769
Emporia State University,Kansas,KS,Public,Public,4 Year,8912,6758,15670,20675,43500,78000,29,272,339,7,52,286,5129,6114
Erskine College,South Carolina,SC,Private,Private,4 Year,10900,34560,45460,34560,43500,78000,3,125,22,0,6,0,597,753
Fairfield University,Connecticut,CT,Private,Private,4 Year,14710,48350,63060,48350,62300,116900,3,137,352,5,113,67,4446,5123
Fairmont State University,West Virginia,WV,Public,Public,4 Year,9004,7514,16518,16324,42900,74100,15,214,76,3,18,96,3613,4035
Faulkner University,Alabama,AL,Private,Private,4 Year,7750,21690,29440,21690,39400,71300,24,1505,71,3,19,52,1661,3335
Felician University,New Jersey,NJ,Private,Private,4 Year,12880,34315,47195,34315,53200,98200,10,382,486,11,134,12,918,1953
Ferris State University,Michigan,MI,Public,Public,4 Year,9894,12630,22524,12630,50000,89300,78,1013,556,7,207,443,12296,14600
Ferrum College,Virginia,VA,Private,Private,4 Year,11500,34175,45675,34175,43000,80600,6,436,77,3,8,69,852,1451
Fisk University,Tennessee,TN,Private,Private,4 Year,10790,21480,32270,21480,45300,83600,0,653,18,1,6,12,82,772
Florida Atlantic University,Florida,FL,Public,Public,4 Year,11896,6039,17935,21595,49400,91200,57,5678,7255,36,1318,924,15029,30297
Florida Institute of Technology,Florida,FL,Private,Private,4 Year,12880,41850,54730,41850,58300,105400,28,533,359,17,174,97,5185,6393
Florida International University,Florida,FL,Public,Public,4 Year,10882,6558,17440,18956,49600,90100,42,5977,31211,57,1434,1042,9847,49610
Florida State University,Florida,FL,Public,Public,4 Year,10816,6516,17332,21683,50800,92700,116,3377,6594,59,1029,1063,28988,41226
Fordham University,New York,NY,Private,Private,4 Year,17969,52687,70656,52687,58700,112500,18,959,1879,15,1164,420,10776,15231
Fort Hays State University,Kansas,KS,Public,Public,4 Year,8300,5133,13433,15201,45100,79300,56,514,877,15,130,281,11952,13825
Fort Lewis College,Colorado,CO,Public,Public,4 Year,9878,9040,18918,19696,48300,82600,887,31,388,8,24,227,2226,3791
Francis Marion University,South Carolina,SC,Public,Public,4 Year,7948,11160,19108,21544,42900,77600,11,1778,56,2,47,38,2012,3944
Franklin Pierce University,New Hampshire,NH,Private,Private,4 Year,13345,36900,50245,36900,47800,85600,10,81,40,3,36,63,2042,2275
Freed-Hardeman University,Tennessee,TN,Private,Private,4 Year,8260,21950,30210,21950,43700,78200,4,230,38,0,10,28,1557,1867
Friends University,Kansas,KS,Private,Private,4 Year,7972,28415,36387,28415,44700,76500,25,204,68,7,51,118,1409,1882
Frostburg State University,Maryland,MD,Public,Public,4 Year,10202,9172,19374,22892,49600,87000,6,1466,244,5,99,223,3602,5645
George Fox University,Oregon,OR,Private,Private,4 Year,11250,36020,47270,36020,51200,89600,24,68,263,19,133,172,3107,3786
George Mason University,Virginia,VA,Public,Public,4 Year,11460,12462,23922,35922,58900,105700,72,3153,3420,122,5001,1209,20752,33729
Georgetown College,Kentucky,KY,Private,Private,4 Year,9780,38650,48430,38650,45000,81900,3,105,38,0,11,34,1071,1262
Georgia Southern University,Georgia,GA,Public,Public,4 Year,10070,7422,17492,20904,49000,88000,89,5249,1235,22,280,383,13259,20517
Georgia State University,Georgia,GA,Public,Public,4 Year,11378,10858,22236,29432,50600,90800,62,11875,2651,27,3386,1335,13220,32556
Gettysburg College,Pennsylvania,PA,Private,Private,4 Year,13010,54480,67490,54480,58400,109300,1,87,113,0,45,70,2131,2447
Goddard College,Vermont,VT,Private,Private,4 Year,1698,16586,18284,16586,42700,76900,2,19,24,2,10,9,472,538
Goldey-Beacom College,Delaware,DE,Private,Private,4 Year,6400,24300,30700,24300,49800,86900,4,215,28,0,55,26,1684,2012
Gonzaga University,Washington,WA,Private,Private,4 Year,11944,43210,55154,43210,57800,107600,57,119,561,27,289,307,5992,7352
Goucher College,Maryland,MD,Private,Private,4 Year,14506,44300,58806,44300,49400,90600,5,218,137,1,55,62,1642,2120
Grambling State University,Louisiana,LA,Public,Public,4 Year,7192,7435,14627,16458,43100,73100,13,4088,41,2,10,56,294,4504
Green Mountain College,Vermont,VT,Private,Private,4 Year,11722,37002,48724,37002,42000,75200,8,34,28,0,7,9,747,833
Grinnell College,Iowa,IA,Private,Private,4 Year,12810,52392,65202,52392,53400,96500,3,100,134,0,128,74,1295,1734
Gustavus Adolphus College,Minnesota,MN,Private,Private,4 Year,9910,45400,55310,45400,51200,96800,2,46,81,1,97,86,2144,2457
Hamline University,Minnesota,MN,Private,Private,4 Year,10358,41298,51656,41298,48100,90400,25,190,180,5,180,131,3758,4469
Hampden-Sydney College,Virginia,VA,Private,Private,4 Year,13558,45746,59304,45746,58300,108600,5,85,23,0,20,60,912,1105
Hampton University,Virginia,VA,Private,Private,4 Year,11778,26702,38480,26702,52700,92600,6,3921,50,0,71,1,344,4393
Hanover College,Indiana,IN,Private,Private,4 Year,11580,37670,49250,37670,47500,85100,7,55,26,0,16,21,1020,1145
Harding University,Arkansas,AR,Private,Private,4 Year,7044,20135,27179,20135,49200,88600,46,303,158,1,86,87,5378,6059
Harvey Mudd College,California,CA,Private,Private,4 Year,18127,56876,75003,56876,88800,158200,4,13,80,0,167,50,490,804
Hastings College,Nebraska,NE,Private,Private,4 Year,9700,30050,39750,30050,48600,87100,6,41,67,4,16,33,1045,1212
Haverford College,Pennsylvania,PA,Private,Private,4 Year,16402,54592,70994,54592,59300,112300,4,69,102,0,100,70,849,1194
Hawaii Pacific University,Hawaii,HI,Private,Private,4 Year,14800,25980,40780,25980,52200,93500,24,345,764,128,921,987,2658,5827
Henderson State University,Arkansas,AR,Public,Public,4 Year,7504,8436,15940,10086,42900,79800,7,846,147,0,23,152,2452,3627
Hendrix College,Arkansas,AR,Private,Private,4 Year,12284,45790,58074,45790,48100,90300,22,65,65,1,77,9,1119,1358
High Point University,North Carolina,NC,Private,Private,4 Year,14130,35118,49248,35118,48600,84300,21,246,173,0,61,167,3731,4399
Hofstra University,New York,NY,Private,Private,4 Year,15948,46760,62708,46760,57300,110400,31,909,1254,78,893,198,7590,10953
Holy Cross College,Indiana,IN,Private,Private,4 Year,11500,30820,42320,30820,48100,87800,2,49,56,1,8,18,386,520
Hood College,Maryland,MD,Private,Private,4 Year,12700,39492,52192,39492,47900,82600,1,255,138,0,78,73,1820,2365
Hope College,Michigan,MI,Private,Private,4 Year,10310,34010,44320,34010,49200,90900,3,85,258,0,54,67,2988,3455
Huntingdon College,Alabama,AL,Private,Private,4 Year,9750,27400,37150,27400,42400,78900,14,229,29,2,9,30,847,1160
Husson University,Maine,ME,Private,Private,4 Year,9830,18180,28010,18180,43300,77600,16,147,46,7,73,39,3087,3415
Idaho State University,Idaho,ID,Public,Public,4 Year,7207,7420,14627,22940,50800,91800,141,156,1122,28,179,311,11492,13429
Illinois Institute of Technology,Illinois,IL,Private,Private,4 Year,12762,47296,60058,47296,64600,118500,12,292,600,13,497,72,6412,7898
Illinois State University,Illinois,IL,Public,Public,4 Year,9850,14516,24366,26040,51200,95000,24,1454,1711,18,434,478,16496,20615
Illinois Wesleyan University,Illinois,IL,Private,Private,4 Year,10984,47636,58620,47636,53100,96000,5,87,128,1,82,43,1547,1893
Indiana State University,Indiana,IN,Public,Public,4 Year,10590,9090,19680,19836,47900,85600,36,2199,395,8,179,374,9992,13183
Iowa State University,Iowa,IA,Public,Public,4 Year,8720,8988,17708,23392,56100,101300,80,891,1451,31,940,672,30370,34435
Jackson State University,Mississippi,MS,Public,Public,4 Year,9552,8226,17778,19454,41700,74600,39,8491,38,1,43,96,800,9508
Jacksonville State University,Alabama,AL,Public,Public,4 Year,8100,10425,18525,20145,43800,80000,61,2030,110,7,50,0,6401,8659
Jacksonville University,Florida,FL,Private,Private,4 Year,14080,36670,50750,36670,50100,90400,14,607,277,8,70,113,2996,4085
James Madison University,Virginia,VA,Public,Public,4 Year,10092,12016,22108,28416,57400,102600,31,863,1043,39,889,709,17281,20855
Jefferson College of Health Sciences,Virginia,VA,Private,Private,4 Year,5870,26886,32756,26886,55500,97600,1,82,40,0,28,14,966,1131
John Brown University,Arkansas,AR,Private,Private,4 Year,9224,26928,36152,26928,47000,82700,51,108,152,3,34,103,2399,2850
John Carroll University,Ohio,OH,Private,Private,4 Year,11874,41340,53214,41340,51600,97300,2,186,110,0,62,77,3251,3688
Johns Hopkins University,Maryland,MD,Private,Private,4 Year,15836,54240,70076,54240,67200,117100,35,1419,1498,27,2919,690,14784,21372
Kalamazoo College,Michigan,MI,Private,Private,4 Year,9756,48516,58272,48516,51600,94500,2,76,135,3,86,70,1089,1461
Kansas State University,Kansas,KS,Public,Public,4 Year,9680,10263,19943,25767,52500,97200,94,954,1419,36,381,695,21187,24766
Kansas Wesleyan University,Kansas,KS,Private,Private,4 Year,9500,29500,39000,29500,44700,79400,4,43,89,2,8,14,550,710
Kean University,New Jersey,NJ,Public,Public,4 Year,14470,12348,26818,19383,48200,90000,19,2802,3443,48,802,244,7001,14359
Keene State College,New Hampshire,NH,Public,Public,4 Year,11026,14212,25238,23176,48900,83600,14,48,156,2,56,97,4584,4957
Kennesaw State University,Georgia,GA,Public,Public,4 Year,11467,7432,18899,21158,52500,94600,60,4845,1862,39,861,1018,17029,25714
Kentucky Christian University,Kentucky,KY,Private,Private,4 Year,8270,19820,28090,19820,39600,70300,2,56,8,0,4,7,581,658
Kentucky State University,Kentucky,KY,Public,Public,4 Year,6690,8090,14780,19390,40700,73100,3,1007,33,4,10,40,798,1895
Kentucky Wesleyan College,Kentucky,KY,Private,Private,4 Year,9764,26440,36204,26440,42100,76800,1,102,12,0,3,0,591,709
Kenyon College,Ohio,OH,Private,Private,4 Year,12510,55930,68440,55930,55000,103800,9,58,100,0,87,59,1349,1662
Kettering College,Ohio,OH,Private,Private,4 Year,4100,16200,20300,16200,54300,95800,2,35,25,1,35,15,647,760
Kettering University,Michigan,MI,Private,Private,4 Year,8240,43490,51730,43490,69900,125000,4,91,71,2,61,48,1802,2079
Knox College,Illinois,IL,Private,Private,4 Year,9870,46554,56424,46554,50600,95400,3,110,175,0,77,56,978,1399
La Salle University,Pennsylvania,PA,Private,Private,4 Year,15080,30560,45640,30560,55800,104800,16,1078,462,7,286,349,4044,6242
Lafayette College,Pennsylvania,PA,Private,Private,4 Year,15640,52880,68520,52880,66500,122500,3,118,166,1,81,53,2081,2503
Lake Forest College,Illinois,IL,Private,Private,4 Year,10390,47064,57454,47064,55400,102600,4,108,243,0,81,57,1133,1626
Lake Superior State University,Michigan,MI,Public,Public,4 Year,9882,12090,21972,12090,45900,83500,208,80,58,0,13,0,2048,2407
Lamar University,Texas,TX,Public,Public,4 Year,8920,10192,19112,22642,53300,101200,55,3532,2070,10,478,258,8492,14895
Lander University,South Carolina,SC,Public,Public,4 Year,9100,11700,20800,21300,42600,77100,4,858,36,2,42,55,1790,2787
Langston University,Oklahoma,OK,Public,Public,4 Year,9476,5950,15426,13300,46500,81500,37,1969,31,0,0,0,445,2482
Lawrence Technological University,Michigan,MI,Private,Private,4 Year,9950,33570,43520,33570,57900,108400,13,234,100,1,925,0,2742,4015
Lawrence University,Wisconsin,WI,Private,Private,4 Year,10341,47475,57816,47475,51500,98800,8,51,100,0,60,59,1233,1511
Lehigh University,Pennsylvania,PA,Private,Private,4 Year,13600,52930,66530,52930,69500,134100,7,239,475,1,479,139,5779,7119
Lenoir-Rhyne University,North Carolina,NC,Private,Private,4 Year,12510,36400,48910,36400,46400,86300,12,266,60,1,30,52,1629,2050
LeTourneau University,Texas,TX,Private,Private,4 Year,9970,30210,40180,30210,56600,98900,10,278,227,2,28,99,2023,2667
Lewis & Clark College,Oregon,OR,Private,Private,4 Year,12490,50934,63424,50934,50000,93200,55,74,287,10,226,28,2824,3504
Lewis University,Illinois,IL,Private,Private,4 Year,10578,32450,43028,32450,49700,89800,8,610,1043,14,204,149,4661,6689
Lewis-Clark State College,Idaho,ID,Public,Public,4 Year,7580,6618,14198,19236,44900,77600,99,33,215,13,39,102,3803,4304
Limestone College,South Carolina,SC,Private,Private,4 Year,9765,26000,35765,26000,42100,76500,9,1521,92,1,11,13,1567,3214
Lindenwood University,Missouri,MO,Private,Private,4 Year,9000,17600,26600,17600,45100,78500,46,2019,374,21,58,307,9326,12151
Lindsey Wilson College,Kentucky,KY,Private,Private,4 Year,9385,24850,34235,24850,35300,64100,12,253,26,1,17,33,2299,2641
Lipscomb University,Tennessee,TN,Private,Private,4 Year,12652,32144,44796,32144,49000,84800,4,371,225,4,119,66,3700,4489
Longwood University,Virginia,VA,Public,Public,4 Year,11746,13340,25086,29300,47300,83300,15,415,229,6,73,164,4194,5096
Loras College,Iowa,IA,Private,Private,4 Year,8275,34184,42459,34184,48000,90100,1,39,89,2,13,22,1403,1569
Louisiana College,Louisiana,LA,Private,Private,4 Year,5618,17000,22618,17000,44800,79800,10,280,40,1,12,12,901,1256
Louisiana Tech University,Louisiana,LA,Public,Public,4 Year,6495,9645,16140,18558,53100,100700,43,1441,123,16,131,190,9281,11225
Loyola Marymount University,California,CA,Private,Private,4 Year,14490,48522,63012,48522,58500,113300,18,585,2190,8,1054,616,5044,9515
Loyola University Chicago,Illinois,IL,Private,Private,4 Year,14480,44048,58528,44048,53400,96000,15,920,1793,33,1449,721,10971,15902
Loyola University Maryland,Maryland,MD,Private,Private,4 Year,14430,49085,63515,49085,59900,111200,12,465,470,5,190,135,4690,5967
Loyola University New Orleans,Louisiana,LA,Private,Private,4 Year,13380,39692,53072,39692,47900,88600,32,655,541,3,143,133,2823,4330
Luther College,Iowa,IA,Private,Private,4 Year,9460,42290,51750,42290,48200,85900,8,34,80,0,39,49,2175,2385
Lyndon State College,Vermont,VT,Public,Public,4 Year,10598,12074,22672,25394,41500,75100,13,49,48,1,11,28,1280,1430
Lyon College,Arkansas,AR,Private,Private,4 Year,9130,28790,37920,28790,41200,74300,10,47,44,0,11,0,600,712
Macalester College,Minnesota,MN,Private,Private,4 Year,12156,54344,66500,54344,53600,100400,1,49,123,1,146,111,1642,2073
Maharishi University of Management,Iowa,IA,Private,Private,4 Year,7400,16530,23930,16530,46800,85200,3,94,43,0,25,22,1267,1454
Maine College of Art,Maine,ME,Private,Private,4 Year,11890,35000,46890,35000,36300,64600,0,7,27,0,10,22,393,459
Maine Maritime Academy,Maine,ME,Public,Public,4 Year,10310,13478,23788,27098,67000,121800,3,6,8,2,7,0,1034,1060
Manchester University,Indiana,IN,Private,Private,4 Year,9580,32758,42338,32758,46900,84700,2,86,67,0,61,43,1229,1488
Manhattan Christian College,Kansas,KS,Private,Private,4 Year,9092,15850,24942,15850,39400,72200,5,8,9,0,1,3,285,311
Manhattan College,New York,NY,Private,Private,4 Year,16200,43480,59680,43480,64000,125700,7,138,701,0,151,72,2901,3970
Marietta College,Ohio,OH,Private,Private,4 Year,11320,36040,47360,36040,51200,94300,2,69,38,0,20,32,1339,1500
Marquette University,Wisconsin,WI,Private,Private,4 Year,12720,41870,54590,41870,57800,105900,29,463,950,11,527,329,9436,11745
Marshall University,West Virginia,WV,Public,Public,4 Year,10450,8128,18578,18614,45000,79700,47,738,231,10,157,268,11930,13381
Maryland Institute College of Art,Maryland,MD,Private,Private,4 Year,13280,48630,61910,48630,49000,84500,3,137,140,3,259,116,1604,2262
Marymount University,Virginia,VA,Private,Private,4 Year,13190,31466,44656,31466,52300,93100,17,500,451,17,274,109,2073,3441
Maryville College,Tennessee,TN,Private,Private,4 Year,11424,34880,46304,34880,42800,75300,9,135,34,2,14,32,987,1213
Maryville University of Saint Louis,Missouri,MO,Private,Private,4 Year,10088,28470,38558,28470,46800,80100,39,577,219,13,164,142,4777,5931
Massachusetts Institute of Technology,Massachusetts,MA,Private,Private,4 Year,15510,51832,67342,51832,86300,155200,18,344,1087,1,1832,415,7622,11319
Massachusetts Maritime Academy,Massachusetts,MA,Public,Public,4 Year,12675,9724,22399,26102,67900,117500,18,33,42,1,38,10,1355,1497
Mayville State University,North Dakota,ND,Public,Public,4 Year,7840,6666,14506,9399,43700,81300,19,70,51,5,2,32,902,1081
McDaniel College,Maryland,MD,Private,Private,4 Year,11430,43260,54690,43260,51100,94600,15,336,133,3,89,0,2630,3206
McNeese State University,Louisiana,LA,Public,Public,4 Year,8704,7859,16563,18934,50200,88200,53,1421,211,6,121,172,6253,8237
McPherson College,Kansas,KS,Private,Private,4 Year,8788,28951,37739,28951,44500,80900,2,82,74,4,4,18,475,659
MCPHS University,Massachusetts,MA,Private,Private,4 Year,16400,32705,49105,32705,65900,121800,7,330,184,8,1469,24,4913,6935
Menlo College,California,CA,Private,Private,4 Year,14225,42800,57025,42800,61900,112400,6,55,166,21,56,55,435,794
Mercer University,Georgia,GA,Private,Private,4 Year,11616,36894,48510,36894,48500,85100,45,2550,330,12,566,144,4905,8552
Merrimack College,Massachusetts,MA,Private,Private,4 Year,15845,41760,57605,41760,56000,102500,3,99,177,0,45,47,2966,3337
Methodist University,North Carolina,NC,Private,Private,4 Year,12890,33846,46736,33846,45800,80500,20,454,186,5,37,83,1676,2461
Michigan State University,Michigan,MI,Public,Public,4 Year,10322,14460,24782,39765,55300,100800,127,3196,1878,46,2214,1217,41403,50081
Michigan Technological University,Michigan,MI,Public,Public,4 Year,10756,15646,26402,33726,65000,116300,33,95,117,8,82,156,6608,7099
Mid-America Christian University,Oklahoma,OK,Private,Private,4 Year,8036,18334,26370,18334,40700,74100,105,743,180,10,14,100,1536,2688
MidAmerica Nazarene University,Kansas,KS,Private,Private,4 Year,8708,30736,39444,30736,46200,78500,13,203,104,11,28,23,1488,1870
Middle Tennessee State University,Tennessee,TN,Public,Public,4 Year,9436,9206,18642,28364,46500,81100,71,4407,917,22,589,647,16076,22729
Middlebury College,Vermont,VT,Private,Private,4 Year,15530,54450,69980,54450,60400,109800,7,73,220,0,170,118,1945,2533
Midland University,Nebraska,NE,Private,Private,4 Year,8776,32558,41334,32558,43800,78100,5,68,38,6,10,92,1143,1362
Miles College,Alabama,AL,Private,Private,4 Year,7042,11604,18646,11604,34800,65100,0,1732,5,1,0,10,34,1782
Milligan College,Tennessee,TN,Private,Private,4 Year,7100,33700,40800,33700,41200,74900,3,46,52,2,15,19,1027,1164
Millsaps College,Mississippi,MS,Private,Private,4 Year,13730,39910,53640,39910,49300,88700,6,89,18,0,35,6,688,842
Milwaukee School of Engineering,Wisconsin,WI,Private,Private,4 Year,10389,40749,51138,40749,65700,117600,6,72,125,13,86,41,2467,2810
Minneapolis College of Art and Design,Minnesota,MN,Private,Private,4 Year,5610,39210,44820,39210,47400,84700,7,31,48,0,57,0,640,783
Minot State University,North Dakota,ND,Public,Public,4 Year,6610,7064,13674,7064,44500,74100,52,167,167,13,46,100,2865,3410
Mississippi College,Mississippi,MS,Private,Private,4 Year,10300,18026,28326,18026,45200,79500,26,1164,124,5,118,52,3495,4984
Mississippi State University,Mississippi,MS,Public,Public,4 Year,10090,8760,18850,23360,51100,94100,104,3871,457,17,263,273,15153,20138
Mississippi University for Women,Mississippi,MS,Public,Public,4 Year,7424,7040,14464,7040,39500,69500,6,987,20,2,41,12,1628,2696
Mississippi Valley State University,Mississippi,MS,Public,Public,4 Year,8043,6570,14613,6570,32500,61900,1,2033,25,0,13,0,150,2222
Missouri University of Science and Technology,Missouri,MO,Public,Public,4 Year,10274,10169,20443,28499,67300,122600,30,290,256,14,226,167,7657,8640
Monmouth University,New Jersey,NJ,Private,Private,4 Year,13981,38138,52119,38138,52200,93200,8,351,585,7,215,127,5102,6395
Montana Tech of the University of Montana,Montana,MT,Public,Public,4 Year,9656,7411,17067,22574,61200,112600,35,23,34,0,20,1,1972,2085
Montclair State University,New Jersey,NJ,Public,Public,4 Year,15564,12790,28354,20578,50800,95400,13,1946,4447,38,1015,637,11926,20022
Morehead State University,Kentucky,KY,Public,Public,4 Year,9960,9170,19130,13646,41300,74900,20,409,162,12,41,142,10266,11052
Morehouse College,Georgia,GA,Private,Private,4 Year,13438,27574,41012,27574,55700,98700,1,1988,13,0,1,4,102,2109
Morningside College,Iowa,IA,Private,Private,4 Year,9610,31530,41140,31530,44900,82100,10,29,87,5,14,29,2649,2823
Mount Carmel College of Nursing,Ohio,OH,Private,Private,4 Year,5000,13907,18907,13907,56600,99700,4,64,20,2,15,24,955,1084
Mount Marty College,South Dakota,SD,Private,Private,4 Year,7986,27276,35262,27276,41400,76500,29,34,64,5,13,0,1091,1236
Mount Mercy University,Iowa,IA,Private,Private,4 Year,9534,31798,41332,31798,47200,79000,6,74,24,2,25,25,1606,1762
Muhlenberg College,Pennsylvania,PA,Private,Private,4 Year,11765,52595,64360,52595,53400,101900,4,74,155,0,64,36,2107,2440
Multnomah University,Oregon,OR,Private,Private,4 Year,8870,25900,34770,25900,40500,76400,6,28,46,4,9,30,630,753
Murray State University,Kentucky,KY,Public,Public,4 Year,9190,9084,18274,24540,44800,79900,22,776,196,6,99,171,9937,11207
Nebraska Wesleyan University,Nebraska,NE,Private,Private,4 Year,9622,34202,43824,34202,45700,80500,6,60,92,2,38,30,1855,2083
New College of Florida,Florida,FL,Public,Public,4 Year,9264,6919,16183,29944,47300,86500,1,22,127,0,20,38,626,834
New England College,New Hampshire,NH,Private,Private,4 Year,14222,37914,52136,37914,45700,86400,11,411,148,0,48,20,1761,2399
New England Institute of Technology,Rhode Island,RI,Private,Private,4 Year,13065,29940,43005,29940,51700,93200,19,133,283,2,51,29,2405,2922
New Jersey City University,New Jersey,NJ,Public,Public,4 Year,12738,12051,24789,21573,48700,87600,19,1624,2623,0,660,98,3112,8136
New Jersey Institute of Technology,New Jersey,NJ,Public,Public,4 Year,13600,17338,30938,32750,64600,121300,6,899,1749,3,1901,267,5821,10646
New Mexico Highlands University,New Mexico,NM,Public,Public,4 Year,7872,6150,14022,10302,40400,73800,233,163,1891,18,29,43,1169,3546
New Mexico Institute of Mining and Technology,New Mexico,NM,Public,Public,4 Year,8510,7770,16280,22268,64700,120400,54,46,522,2,67,71,1365,2127
New York University,New York,NY,Private,Private,4 Year,18156,51828,69984,51828,63100,117700,94,2374,4267,45,7314,1248,33932,49274
Newberry College,South Carolina,SC,Private,Private,4 Year,10666,26424,37090,26424,41200,74700,4,283,48,1,7,32,718,1093
Newman University,Kansas,KS,Private,Private,4 Year,8326,30724,39050,30724,48000,88500,45,140,362,7,180,93,2860,3687
Nicholls State University,Louisiana,LA,Public,Public,4 Year,9938,7982,17920,9075,44500,84300,117,1242,197,4,70,176,4486,6292
North Carolina Wesleyan College,North Carolina,NC,Private,Private,4 Year,10800,31000,41800,31000,45300,78800,18,895,38,0,11,32,878,1872
North Central College,Illinois,IL,Private,Private,4 Year,11019,38880,49899,38880,50400,92900,3,118,276,2,66,79,2499,3043
Northeastern State University,Oklahoma,OK,Public,Public,4 Year,7638,6650,14288,14720,44500,77600,1754,360,338,9,167,1138,4544,8310
Northeastern University,Massachusetts,MA,Private,Private,4 Year,16880,51387,68267,51387,62500,109700,10,624,1103,7,1753,597,15704,19798
Northern Arizona University,Arizona,AZ,Public,Public,4 Year,10282,11564,21846,25828,49600,90000,838,888,5368,62,468,1337,18744,27705
Northern Illinois University,Illinois,IL,Public,Public,4 Year,10880,12262,23142,12262,53000,95500,30,2825,2531,22,984,569,13650,20611
Northern Kentucky University,Kentucky,KY,Public,Public,4 Year,10022,10032,20054,19680,49000,87400,55,996,379,17,166,252,13225,15090
Northern State University,South Dakota,SD,Public,Public,4 Year,8029,8498,16527,11471,42300,77700,55,49,79,6,31,52,3259,3531
Northwest Christian University,Oregon,OR,Private,Private,4 Year,9300,30050,39350,30050,45200,81100,18,16,57,3,15,24,572,705
Northwest Missouri State University,Missouri,MO,Public,Public,4 Year,10016,9805,19821,16457,46900,85100,20,374,182,8,39,167,5930,6720
Northwest Nazarene University,Idaho,ID,Private,Private,4 Year,7400,29300,36700,29300,46200,80600,14,37,175,9,27,44,1943,2249
Northwestern Oklahoma State University,Oklahoma,OK,Public,Public,4 Year,4780,7036,11816,14153,42200,76800,137,136,150,10,15,11,1707,2166
Northwestern University,Illinois,IL,Private,Private,4 Year,16626,54567,71193,54567,63400,115400,22,1058,1662,12,2865,702,15233,21554
Norwich University,Vermont,VT,Private,Private,4 Year,13840,40016,53856,40016,57000,99100,14,200,249,12,85,144,2968,3672
Notre Dame of Maryland University,Maryland,MD,Private,Private,4 Year,11850,36900,48750,36900,48300,86400,22,631,113,6,188,0,1804,2764
Nova Southeastern University,Florida,FL,Private,Private,4 Year,13250,30900,44150,30900,50200,89800,42,5374,6150,13,1491,428,10650,24148
Oakland University,Michigan,MI,Public,Public,4 Year,10100,12606,22706,24230,51300,93300,79,1601,565,17,955,492,16810,20519
Oakwood University,Alabama,AL,Private,Private,4 Year,9312,16720,26032,16720,43500,78800,11,1629,47,0,9,0,243,1939
Oberlin College,Ohio,OH,Private,Private,4 Year,16338,55054,71392,55054,53100,96800,3,154,215,2,124,168,2312,2978
Oglethorpe University,Georgia,GA,Private,Private,4 Year,13200,38100,51300,38100,52400,91400,3,202,113,0,43,29,704,1094
Ohio Northern University,Ohio,OH,Private,Private,4 Year,11650,32260,43910,32260,54400,103900,4,113,40,3,56,105,3374,3695
Ohio Wesleyan University,Ohio,OH,Private,Private,4 Year,12430,45760,58190,45760,51300,99200,1,116,72,0,40,79,1426,1734
Oklahoma Baptist University,Oklahoma,OK,Private,Private,4 Year,7350,28258,35608,28258,43900,76600,107,118,45,5,17,159,1528,1979
Oklahoma Christian University,Oklahoma,OK,Private,Private,4 Year,8190,22760,30950,22760,49700,87900,48,308,142,1,203,153,1620,2475
Oklahoma City University,Oklahoma,OK,Private,Private,4 Year,8896,31026,39922,31026,47700,87900,87,162,203,1,74,200,2308,3035
Oklahoma Panhandle State University,Oklahoma,OK,Public,Public,4 Year,4695,8194,12889,9133,42300,74400,43,135,211,0,17,34,858,1298
Oklahoma Wesleyan University,Oklahoma,OK,Private,Private,4 Year,8644,26956,35600,26956,43300,78700,97,88,96,3,5,55,1001,1345
Old Dominion University,Virginia,VA,Public,Public,4 Year,11620,10872,22492,29772,50200,89900,89,5980,1578,98,995,1319,14873,24932
Oral Roberts University,Oklahoma,OK,Private,Private,4 Year,9450,27728,37178,27728,45900,85100,113,565,273,0,80,154,2296,3481
Oregon Institute of Technology,Oregon,OR,Public,Public,4 Year,9058,9987,19045,28056,61200,106800,49,58,357,27,232,214,3323,4260
Oregon State University,Oregon,OR,Public,Public,4 Year,12855,11166,24021,30141,56200,104800,172,395,2101,98,1901,1653,22566,28886
Ouachita Baptist University,Arkansas,AR,Private,Private,4 Year,7880,26790,34670,26790,44100,80200,11,129,58,1,13,0,1289,1501
Pacific Lutheran University,Washington,WA,Private,Private,4 Year,10790,42066,52856,42066,54500,98100,28,95,249,24,218,233,2395,3242
Pacific Northwest College of Art,Oregon,OR,Private,Private,4 Year,12860,38250,51110,38250,46300,85000,7,5,27,1,12,62,405,519
Pacific University,Oregon,OR,Private,Private,4 Year,12528,44298,56826,44298,50200,94000,24,58,288,56,507,267,2440,3640
Park University,Missouri,MO,Private,Private,4 Year,8200,12650,20850,12650,48500,85000,80,2014,1337,48,267,307,6739,10792
Peru State College,Nebraska,NE,Public,Public,4 Year,8010,7452,15462,7482,42600,74800,15,182,130,7,31,68,2066,2499
Pfeiffer University,North Carolina,NC,Private,Private,4 Year,11226,30234,41460,30234,44200,78000,6,460,57,1,24,20,1216,1784
Philander Smith College,Arkansas,AR,Private,Private,4 Year,8250,12414,20664,12414,34600,61200,1,512,2,1,3,11,37,567
Pittsburg State University,Kansas,KS,Public,Public,4 Year,7778,7298,15076,18642,47100,84900,104,273,312,10,56,333,6391,7479
Plymouth State University,New Hampshire,NH,Public,Public,4 Year,11100,14099,25199,22769,47000,82200,13,101,122,0,100,61,4458,4855
Pomona College,California,CA,Private,Private,4 Year,16716,52780,69496,52780,63800,117200,4,109,232,2,213,122,968,1650
Portland State University,Oregon,OR,Public,Public,4 Year,10428,9105,19533,27060,50800,90500,376,886,2664,164,2024,1314,20268,27696
Prairie View A&M University,Texas,TX,Public,Public,4 Year,8925,10533,19458,24843,57800,99400,25,7087,229,8,243,58,779,8429
Presbyterian College,South Carolina,SC,Private,Private,4 Year,10480,38660,49140,38660,48800,89900,4,199,28,1,45,23,1160,1460
Prescott College,Arizona,AZ,Private,Private,4 Year,7700,31485,39185,31485,41200,73500,22,24,21,2,12,39,728,848
Princeton University,New Jersey,NJ,Private,Private,4 Year,16290,49330,65620,49330,75200,139400,10,474,571,7,1282,281,5463,8088
Providence College,Rhode Island,RI,Private,Private,4 Year,14700,50390,65090,50390,58900,106900,8,189,318,9,51,77,3881,4533
Queens University of Charlotte,North Carolina,NC,Private,Private,4 Year,10860,34684,45544,34684,49400,86600,9,385,120,1,54,27,1652,2248
Quinnipiac University,Connecticut,CT,Private,Private,4 Year,14540,47960,62500,47960,55900,97700,20,463,694,6,291,140,7421,9035
Radford University,Virginia,VA,Public,Public,4 Year,9406,11210,20616,22845,48900,82900,27,1101,499,20,143,435,7573,9798
Ramapo College of New Jersey,New Jersey,NJ,Public,Public,4 Year,12450,14374,26824,23715,51600,95200,16,319,781,11,377,70,4429,6003
Randolph College,Virginia,VA,Private,Private,4 Year,13580,39585,53165,39585,47000,86100,4,74,31,0,20,24,540,693
Reed College,Oregon,OR,Private,Private,4 Year,14210,56340,70550,56340,56100,104900,4,26,146,3,80,113,1022,1394
Regis University,Colorado,CO,Private,Private,4 Year,11560,36810,48370,36810,55500,94800,57,521,1392,21,428,234,6555,9208
Rensselaer Polytechnic Institute,New York,NY,Private,Private,4 Year,15260,53880,69140,53880,71300,134100,6,182,439,3,629,386,5190,6835
Rhode Island College,Rhode Island,RI,Public,Public,4 Year,11829,8929,20758,21692,47200,83500,32,639,1153,10,249,144,6414,8641
Rhode Island School of Design,Rhode Island,RI,Private,Private,4 Year,13400,50960,64360,50960,55500,100600,3,50,189,2,386,86,1733,2449
Rhodes College,Tennessee,TN,Private,Private,4 Year,11403,47890,59293,47890,51900,97800,6,128,73,0,133,62,1652,2054
Rice University,Texas,TX,Private,Private,4 Year,14000,47350,61350,47350,71000,129500,5,340,746,6,1102,222,4200,6621
Rider University,New Jersey,NJ,Private,Private,4 Year,14700,41310,56010,41310,51600,99000,8,529,528,8,235,118,3868,5294
Ripon College,Wisconsin,WI,Private,Private,4 Year,8400,43808,52208,43808,46300,89600,2,19,40,0,12,15,752,840
Roanoke College,Virginia,VA,Private,Private,4 Year,13690,44030,57720,44030,48500,85100,7,110,76,2,30,85,1740,2050
Rockhurst University,Missouri,MO,Private,Private,4 Year,10200,37590,47790,37590,54000,92500,5,146,143,3,91,79,2535,3002
Rocky Mountain College,Montana,MT,Private,Private,4 Year,8330,28512,36842,28512,46000,82900,21,32,18,5,10,67,854,1007
Roger Williams University,Rhode Island,RI,Private,Private,4 Year,15890,34522,50412,34522,52900,92700,42,117,238,3,107,4,4373,4884
Rogers State University,Oklahoma,OK,Public,Public,4 Year,8616,6870,15486,15210,41400,73800,510,94,181,4,49,709,2483,4030
Rollins College,Florida,FL,Private,Private,4 Year,14735,49760,64495,49760,49000,87000,9,197,487,2,95,91,2326,3207
Rose-Hulman Institute of Technology,Indiana,IN,Private,Private,4 Year,14766,49871,64637,49871,75000,135800,3,57,68,2,82,90,2086,2388
Rowan University,New Jersey,NJ,Public,Public,4 Year,12552,13697,26249,22339,51100,91200,35,1342,1301,13,814,317,10956,14778
Rust College,Mississippi,MS,Private,Private,4 Year,4300,9900,14200,9900,34800,62400,0,924,0,0,2,0,37,963
Sacred Heart University,Connecticut,CT,Private,Private,4 Year,15310,41420,56730,41420,55000,100500,14,361,497,11,174,89,6635,7781
Saginaw Valley State University,Michigan,MI,Public,Public,4 Year,10186,10308,20494,24215,46400,82200,32,950,336,4,72,162,8273,9829
Saint Anselm College,New Hampshire,NH,Private,Private,4 Year,14500,41200,55700,41200,56400,100300,3,36,57,2,12,34,1824,1968
Saint Joseph's College of Maine,Maine,ME,Private,Private,4 Year,13680,35650,49330,35650,46900,84300,13,96,63,1,39,0,2721,2933
Saint Louis University,Missouri,MO,Private,Private,4 Year,12290,43884,56174,43884,54200,95300,13,1091,567,0,1111,699,13571,17052
Saint Martin's University,Washington,WA,Private,Private,4 Year,11445,37356,48801,37356,53200,91800,9,109,181,38,80,123,1261,1801
Saint Mary's College of California,California,CA,Private,Private,4 Year,15370,47280,62650,47280,59900,110800,13,212,918,24,414,221,2310,4112
Saint Michael's College,Vermont,VT,Private,Private,4 Year,12220,45375,57595,45375,52900,98500,5,51,98,1,43,43,2377,2618
Saint Peter's University,New Jersey,NJ,Private,Private,4 Year,15414,37486,52900,37486,52900,95900,24,819,950,14,235,57,1203,3302
Saint Xavier University,Illinois,IL,Private,Private,4 Year,11340,33880,45220,33880,49400,91200,12,668,920,2,112,71,2288,4073
Salisbury University,Maryland,MD,Public,Public,4 Year,11950,9824,21774,19526,50400,89800,34,1091,345,10,216,306,6768,8770
Salve Regina University,Rhode Island,RI,Private,Private,4 Year,14500,40550,55050,40550,53000,93900,12,67,163,2,34,47,2414,2739
Samford University,Alabama,AL,Private,Private,4 Year,10550,31650,42200,31650,48400,90500,17,372,218,1,80,50,4195,4933
San Jose State University,California,CA,Public,Public,4 Year,16442,7796,24238,17300,63000,114700,44,1029,7407,242,10381,1559,12051,32713
Santa Clara University,California,CA,Private,Private,4 Year,14910,51711,66621,51711,69900,134700,10,238,1283,20,1416,461,5587,9015
Savannah College of Art and Design,Georgia,GA,Private,Private,4 Year,14550,36630,51180,36630,46800,80100,61,1270,859,27,511,16,8603,11347
Seattle Pacific University,Washington,WA,Private,Private,4 Year,11796,42939,54735,42939,53600,103400,19,152,334,11,430,292,2979,4217
Seattle University,Washington,WA,Private,Private,4 Year,12288,44610,56898,44610,60600,113700,41,215,612,43,1011,457,4894,7273
Seton Hall University,New Jersey,NJ,Private,Private,4 Year,15800,42470,58270,42470,57100,103800,10,1098,1364,30,688,189,6248,9627
Shenandoah University,Virginia,VA,Private,Private,4 Year,10370,32530,42900,32530,48700,86600,53,411,182,12,269,0,2766,3693
Shepherd University,West Virginia,WV,Public,Public,4 Year,10500,7548,18048,18048,47100,87100,26,321,111,3,74,35,3471,4041
Shorter University,Georgia,GA,Private,Private,4 Year,9400,22370,31770,22370,45600,79900,8,356,53,2,13,28,1106,1566
Sierra Nevada College,Nevada,NV,Private,Private,4 Year,13357,34241,47598,34241,54000,95500,31,41,33,10,19,3,902,1039
Smith College,Massachusetts,MA,Private,Private,4 Year,17520,52404,69924,52404,52700,98200,5,149,276,2,348,128,2081,2989
South Carolina State University,South Carolina,SC,Public,Public,4 Year,9890,11060,20950,21750,44500,80800,4,3128,18,1,22,1,157,3331
South Dakota School of Mines and Technology,South Dakota,SD,Public,Public,4 Year,8440,9779,18219,14021,66500,118500,50,50,110,5,44,96,2443,2798
South Dakota State University,South Dakota,SD,Public,Public,4 Year,7896,8764,16660,12128,50500,91900,127,255,241,13,140,229,11538,12543
Southeast Missouri State University,Missouri,MO,Public,Public,4 Year,8935,7418,16353,13155,43700,79100,55,1022,189,4,118,13,10686,12087
Southeastern Louisiana University,Louisiana,LA,Public,Public,4 Year,8420,8165,16585,20643,46700,83900,35,2148,893,14,128,757,10512,14487
Southeastern Oklahoma State University,Oklahoma,OK,Public,Public,4 Year,6970,6750,13720,15390,45000,80500,698,208,154,7,37,522,2252,3878
Southern Adventist University,Tennessee,TN,Private,Private,4 Year,6940,21950,28890,21950,47500,84000,13,380,604,19,228,105,1826,3175
Southern Connecticut State University,Connecticut,CT,Public,Public,4 Year,12860,10875,23735,22115,48500,83600,19,1539,1114,2,271,230,7650,10825
Southern Methodist University,Texas,TX,Private,Private,4 Year,16845,54493,71338,54493,59700,110400,31,669,1172,15,671,291,8423,11272
Southern Nazarene University,Oklahoma,OK,Private,Private,4 Year,8496,25188,33684,25188,46100,81000,93,318,134,8,55,70,1576,2254
Southern New Hampshire University,New Hampshire,NH,Private,Private,4 Year,13120,31136,44256,31136,47400,83400,152,2373,1009,33,337,60,39310,43274
Southern Oregon University,Oregon,OR,Public,Public,4 Year,13199,9654,22853,25584,46000,81200,71,116,477,26,124,274,4866,5954
Southern University at New Orleans,Louisiana,LA,Public,Public,4 Year,9040,9371,18411,11160,40100,71000,3,1771,13,0,10,0,306,2103
Southern Vermont College,Vermont,VT,Private,Private,4 Year,11000,25511,36511,25511,42900,78700,4,59,43,1,3,7,340,457
Southern Wesleyan University,South Carolina,SC,Private,Private,4 Year,9030,25476,34506,25476,42900,74600,5,483,56,1,10,26,1197,1778
Southwestern Oklahoma State University,Oklahoma,OK,Public,Public,4 Year,5830,7035,12865,13935,47900,90800,210,261,350,6,145,363,3659,4994
Spalding University,Kentucky,KY,Private,Private,4 Year,7600,24500,32100,24500,44800,79200,3,425,66,5,32,57,1723,2311
Spelman College,Georgia,GA,Private,Private,4 Year,13865,29314,43179,29314,50200,85400,3,1855,7,0,2,58,210,2135
Spring Hill College,Alabama,AL,Private,Private,4 Year,13462,39464,52926,39464,46600,89100,10,210,77,1,16,45,1017,1376
St. Mary's University,Texas,TX,Private,Private,4 Year,10270,30650,40920,30650,52900,95300,23,142,2060,10,95,8,1374,3712
Stanford University,California,CA,Private,Private,4 Year,15763,51354,67117,51354,79000,145200,98,633,1749,30,2630,1142,10681,16963
Stephens College,Missouri,MO,Private,Private,4 Year,10632,30950,41582,30950,42800,77200,3,117,31,4,12,48,647,862
Stetson University,Florida,FL,Private,Private,4 Year,13052,46030,59082,46030,47000,86000,16,288,564,1,94,124,3050,4137
Stevens Institute of Technology,New Jersey,NJ,Private,Private,4 Year,15244,52202,67446,52202,75100,139900,5,96,321,0,436,0,5267,6125
Stevenson University,Maryland,MD,Private,Private,4 Year,13130,36182,49312,36182,50400,91600,5,1267,194,8,133,114,2601,4322
Stockton University,New Jersey,NJ,Public,Public,4 Year,12282,13739,26021,20866,47400,85800,10,532,848,12,439,239,6490,8570
Stonehill College,Massachusetts,MA,Private,Private,4 Year,16000,42746,58746,42746,55900,103200,1,99,103,1,51,41,1988,2284
Swarthmore College,Pennsylvania,PA,Private,Private,4 Year,15474,52588,68062,52588,67500,123200,2,90,206,1,252,120,871,1542
Tabor College,Kansas,KS,Private,Private,4 Year,9850,28245,38095,28245,43300,77500,3,64,83,2,5,25,584,766
Taylor University,Indiana,IN,Private,Private,4 Year,9614,34114,43728,34114,48700,90600,6,55,63,7,63,15,1937,2146
Tennessee State University,Tennessee,TN,Public,Public,4 Year,7806,8008,15814,21364,47200,78400,14,5750,112,0,91,276,2784,9027
Tennessee Technological University,Tennessee,TN,Public,Public,4 Year,9736,9103,18839,25759,53100,95100,17,416,252,4,147,250,10253,11339
Texas Christian University,Texas,TX,Private,Private,4 Year,12804,46950,59754,46950,56000,98700,81,479,1060,29,277,55,8052,10033
Texas Tech University,Texas,TX,Public,Public,4 Year,9530,11045,20575,23495,56800,106500,113,2011,7075,39,850,1053,24017,35158
Thomas More College,Kentucky,KY,Private,Private,4 Year,7950,31120,39070,31120,50000,90900,2,109,23,1,12,32,1476,1655
Thomas More College of Liberal Arts,New Hampshire,NH,Private,Private,4 Year,9700,21600,31300,21600,48900,88300,0,1,2,0,2,0,88,93
Tougaloo College,Mississippi,MS,Private,Private,4 Year,6643,10790,17433,10790,36900,66400,1,887,4,0,0,0,8,900
Towson University,Maryland,MD,Public,Public,4 Year,13034,9940,22974,23208,51200,91200,33,3456,1196,26,1049,813,15712,22285
Transylvania University,Kentucky,KY,Private,Private,4 Year,10460,38750,49210,38750,47900,85600,1,31,46,1,20,30,885,1014
Trevecca Nazarene University,Tennessee,TN,Private,Private,4 Year,8400,25598,33998,25598,45300,81700,9,372,71,3,27,73,2051,2606
Trine University,Indiana,IN,Private,Private,4 Year,10810,32175,42985,32175,55100,100300,12,86,148,4,48,74,2459,2831
Trinity University,Texas,TX,Private,Private,4 Year,13464,42976,56440,42976,54900,102900,7,99,454,1,142,108,1621,2432
Troy University,Alabama,AL,Public,Public,4 Year,8185,12460,20645,22875,44500,81500,143,6840,666,19,140,486,10747,19041
Truman State University,Missouri,MO,Public,Public,4 Year,8780,7729,16509,14581,47900,85800,8,218,173,6,115,157,5571,6248
Tufts University,Massachusetts,MA,Private,Private,4 Year,14560,56382,70942,56382,65200,118100,12,368,594,4,1353,409,8167,10907
Tuskegee University,Alabama,AL,Private,Private,4 Year,9650,22170,31820,22170,54500,93500,2,2345,32,0,26,0,698,3103
University of Alabama at Birmingham,Alabama,AL,Public,Public,4 Year,6400,10710,17110,24630,48600,87200,46,3943,496,14,931,563,12705,18698
University of Arizona,Arizona,AZ,Public,Public,4 Year,12550,12487,25037,36386,56100,101000,517,1402,9405,95,2392,1608,26817,42236
University of Arkansas at Little Rock,Arkansas,AR,Public,Public,4 Year,8930,8966,17896,21206,45600,80800,44,2625,713,0,260,823,7180,11645
University of Arkansas at Monticello,Arkansas,AR,Public,Public,4 Year,6824,7696,14520,13546,43500,78300,17,1051,130,5,23,72,2556,3854
University of Arkansas at Pine Bluff,Arkansas,AR,Public,Public,4 Year,7881,7842,15723,14094,40500,70500,3,2295,40,0,15,2,158,2513
University of Bridgeport,Connecticut,CT,Private,Private,4 Year,13860,32850,46710,32850,49900,93600,27,1315,591,11,170,91,2986,5191
University of Central Arkansas,Arkansas,AR,Public,Public,4 Year,6854,8751,15605,15274,44900,79800,55,2011,452,11,185,352,8632,11698
University of Central Florida,Florida,FL,Public,Public,4 Year,9617,6368,15985,22467,49700,88600,120,6400,13108,129,3343,1841,35826,60767
University of Central Missouri,Missouri,MO,Public,Public,4 Year,8766,7673,16439,14442,46900,83300,26,886,322,10,124,266,11745,13379
University of Central Oklahoma,Oklahoma,OK,Public,Public,4 Year,7970,7488,15458,18376,45300,82900,638,1552,1257,28,510,1257,11598,16840
University of Charleston,West Virginia,WV,Private,Private,4 Year,9180,30900,40080,30900,44600,81900,19,209,54,2,57,21,1749,2111
University of Chicago,Illinois,IL,Private,Private,4 Year,16350,58230,74580,58230,64000,114200,35,634,928,6,1923,336,11235,15097
University of Connecticut,Connecticut,CT,Public,Public,4 Year,12874,15730,28604,38098,59100,105200,41,1353,1928,16,2320,597,20286,26541
University of Dallas,Texas,TX,Private,Private,4 Year,12400,40652,53052,40652,53000,96400,8,207,386,4,175,68,1700,2548
University of Dayton,Ohio,OH,Private,Private,4 Year,13580,42900,56480,42900,57400,105000,9,417,310,3,156,126,10322,11343
University of Delaware,Delaware,DE,Public,Public,4 Year,12862,13680,26542,34310,58600,105400,17,1232,1461,21,1018,576,18355,22680
University of Denver,Colorado,CO,Private,Private,4 Year,13005,50556,63561,50556,55700,105100,52,406,1023,14,390,328,9596,11809
University of Detroit Mercy,Michigan,MI,Private,Private,4 Year,9496,28000,37496,28000,51800,92800,17,504,133,11,242,117,3921,4945
University of Dubuque,Iowa,IA,Private,Private,4 Year,9930,34110,44040,34110,44200,79700,11,226,142,4,41,60,1637,2121
University of Evansville,Indiana,IN,Private,Private,4 Year,12460,36416,48876,36416,50300,89900,4,72,71,0,38,49,2333,2567
University of Florida,Florida,FL,Public,Public,4 Year,10120,6381,16501,28658,55800,102800,137,3151,8127,240,3501,1108,33195,49459
University of Georgia,Georgia,GA,Public,Public,4 Year,10038,11830,21868,30404,54400,100700,37,2805,1637,37,2859,1052,26770,35197
University of Hartford,Connecticut,CT,Private,Private,4 Year,12476,40694,53170,40694,55200,101600,16,865,612,5,232,146,4941,6817
University of Hawaii at Hilo,Hawaii,HI,Public,Public,4 Year,11406,7720,19126,20680,44000,77200,20,46,457,391,806,1129,1075,3924
University of Houston,Texas,TX,Public,Public,4 Year,10270,12506,22776,27956,56000,103900,47,4173,10994,97,8118,1218,16267,40914
University of Idaho,Idaho,ID,Public,Public,4 Year,8880,7864,16744,25500,52300,97700,113,142,925,22,161,376,9963,11702
University of Illinois at Chicago,Illinois,IL,Public,Public,4 Year,12074,13764,25838,26980,56300,103800,29,2194,5435,63,5229,618,14401,27969
University of Illinois at Urbana-Champaign,Illinois,IL,Public,Public,4 Year,11308,15094,26402,31664,62600,115300,39,2186,3384,47,6121,1049,32314,45140
University of Indianapolis,Indiana,IN,Private,Private,4 Year,10288,29688,39976,29688,47300,84500,8,456,191,8,85,127,4567,5442
University of Iowa,Iowa,IA,Public,Public,4 Year,11172,9267,20439,31233,54100,99400,50,853,1730,26,1056,630,25625,29970
University of Jamestown,North Dakota,ND,Private,Private,4 Year,7570,21976,29546,21976,47600,85400,15,40,48,3,11,0,853,970
University of Kansas,Kansas,KS,Public,Public,4 Year,10350,11148,21498,27358,53000,98600,142,1133,1554,22,1081,1096,22152,27180
University of Kentucky,Kentucky,KY,Public,Public,4 Year,12982,12245,25227,29099,51700,96400,55,1989,1031,26,807,770,24525,29203
University of Louisiana at Lafayette,Louisiana,LA,Public,Public,4 Year,8516,10616,19132,24344,48200,92500,80,3377,547,15,373,277,12526,17195
University of Louisiana at Monroe,Louisiana,LA,Public,Public,4 Year,7850,8734,16584,20834,48500,92500,29,1936,176,4,197,176,5999,8517
University of Louisville,Kentucky,KY,Public,Public,4 Year,9226,11656,20882,27278,49500,87600,34,2247,813,14,749,784,16920,21561
University of Maine,Maine,ME,Public,Public,4 Year,10418,11170,21588,30970,52000,95000,133,212,241,2,144,261,10293,11286
University of Maine at Farmington,Maine,ME,Public,Public,4 Year,9726,9666,19392,19778,41100,71700,13,35,26,2,14,40,1830,1960
University of Maine at Fort Kent,Maine,ME,Public,Public,4 Year,8220,8115,16335,12315,43500,76300,10,34,19,2,6,25,1231,1327
University of Maine at Machias,Maine,ME,Public,Public,4 Year,8486,7840,16326,15100,37100,66200,22,26,24,0,5,10,723,810
University of Maine at Presque Isle,Maine,ME,Public,Public,4 Year,8406,8035,16441,12235,39000,70700,28,12,13,0,4,28,1053,1138
University of Mary,North Dakota,ND,Private,Private,4 Year,6890,18720,25610,18720,46400,79100,49,77,84,5,32,43,2519,2809
University of Memphis,Tennessee,TN,Public,Public,4 Year,9975,9701,19676,21413,47200,85800,53,7135,757,26,625,630,11833,21059
University of Miami,Florida,FL,Private,Private,4 Year,14108,50226,64334,50226,56200,99600,23,1169,3526,22,953,408,10573,16674
University of Mississippi,Mississippi,MS,Public,Public,4 Year,10696,8660,19356,24614,48500,89100,64,3178,610,23,429,471,17728,22503
University of Mobile,Alabama,AL,Private,Private,4 Year,9600,22820,32420,22820,40600,74100,26,380,23,0,10,34,1127,1600
University of Montevallo,Alabama,AL,Public,Public,4 Year,9330,12760,22090,25780,38900,70700,18,434,93,0,19,68,2438,3070
University of Mount Union,Ohio,OH,Private,Private,4 Year,10200,31260,41460,31260,48300,88500,4,122,41,0,15,85,1995,2262
University of New England,Maine,ME,Private,Private,4 Year,13990,37620,51610,37620,50100,91500,27,387,82,15,301,96,5521,6429
University of New Haven,Connecticut,CT,Private,Private,4 Year,15900,39270,55170,39270,52100,94800,22,602,578,12,169,92,5336,6811
University of New Orleans,Louisiana,LA,Public,Public,4 Year,10575,9054,19629,13890,49900,91600,33,1375,840,3,656,289,6038,9234
University of North Alabama,Alabama,AL,Public,Public,4 Year,9200,10370,19570,18680,43000,75600,62,869,168,5,131,148,5458,6841
University of North Carolina at Chapel Hill,North Carolina,NC,Public,Public,4 Year,11190,8987,20177,35170,55000,100800,133,2304,1895,70,2410,1326,20997,29135
University of North Carolina at Charlotte,North Carolina,NC,Public,Public,4 Year,11100,7044,18144,20478,52500,92600,81,4410,2000,30,1343,856,18518,27238
University of North Carolina School of the Arts,North Carolina,NC,Public,Public,4 Year,9021,9358,18379,25501,46400,82400,5,72,68,2,12,44,755,958
University of North Dakota,North Dakota,ND,Public,Public,4 Year,8974,8695,17669,20759,53800,96000,253,344,420,15,207,404,13263,14906
University of North Florida,Florida,FL,Public,Public,4 Year,9976,6394,16370,20112,48800,86600,20,1553,1481,12,674,779,11465,15984
University of North Georgia,Georgia,GA,Public,Public,4 Year,7876,7336,15212,21148,47300,85600,35,684,1435,17,437,417,13039,16064
University of Northern Colorado,Colorado,CO,Public,Public,4 Year,11204,9786,20990,21474,47700,87100,38,437,1772,22,188,377,9216,12050
University of Northern Iowa,Iowa,IA,Public,Public,4 Year,8948,8938,17886,19480,47100,85300,25,339,377,7,108,210,10862,11928
University of Notre Dame,Indiana,IN,Private,Private,4 Year,15410,53391,68801,53391,67000,130500,21,376,1139,5,573,446,9619,12179
University of Oregon,Oregon,OR,Public,Public,4 Year,12963,11898,24861,35478,51800,95800,162,482,2042,99,1280,1328,18703,24096
University of Pennsylvania,Pennsylvania,PA,Private,Private,4 Year,15616,55584,71200,55584,72800,133900,21,1483,1799,8,3717,777,17001,24806
University of Pikeville,Kentucky,KY,Private,Private,4 Year,7800,20950,28750,20950,39000,70700,11,167,45,2,25,0,2208,2458
University of Portland,Oregon,OR,Private,Private,4 Year,13450,45904,59354,45904,58500,104900,7,41,408,63,404,337,2883,4143
University of Puget Sound,Washington,WA,Private,Private,4 Year,12540,49776,62316,49776,54200,101300,4,29,191,1,189,248,2164,2826
University of Rhode Island,Rhode Island,RI,Public,Public,4 Year,12950,14138,27088,30862,54500,99700,44,803,1288,6,534,394,13502,16571
University of Richmond,Virginia,VA,Private,Private,4 Year,12250,52610,64860,52610,59800,107500,13,345,258,2,215,137,3212,4182
University of Rochester,New York,NY,Private,Private,4 Year,15938,53926,69864,53926,61100,112700,28,491,533,5,915,241,8847,11060
University of Saint Joseph,Connecticut,CT,Private,Private,4 Year,11428,39173,50601,39173,49900,88800,2,252,223,3,116,32,1937,2565
University of San Diego,California,CA,Private,Private,4 Year,12980,49358,62338,49358,58900,109400,42,291,1505,30,641,408,5432,8349
University of San Francisco,California,CA,Private,Private,4 Year,14830,48066,62896,48066,60600,109900,26,464,1919,69,1881,635,5695,10689
University of Science and Arts of Oklahoma,Oklahoma,OK,Public,Public,4 Year,6350,7215,13565,17565,37300,67400,102,37,56,0,9,55,645,904
University of Scranton,Pennsylvania,PA,Private,Private,4 Year,15182,44532,59714,44532,56400,99700,6,155,388,2,149,117,4772,5589
University of Sioux Falls,South Dakota,SD,Private,Private,4 Year,7350,18280,25630,18280,44400,78200,4,46,17,2,8,48,1294,1419
University of South Alabama,Alabama,AL,Public,Public,4 Year,7620,9870,17490,19740,47700,86400,100,3285,402,33,539,325,11121,15805
University of South Dakota,South Dakota,SD,Public,Public,4 Year,8216,9061,17277,12425,47500,87900,168,227,232,51,151,232,9000,10061
University of Southern California,California,CA,Private,Private,4 Year,15395,56225,71620,56225,64500,120600,73,2238,5286,104,7696,1380,25676,42453
University of Southern Maine,Maine,ME,Public,Public,4 Year,9450,9520,18970,22780,46900,81300,76,224,147,7,164,169,7641,8428
University of Southern Mississippi,Mississippi,MS,Public,Public,4 Year,9857,8734,18591,10734,45100,83900,48,4033,457,14,172,316,9752,14792
University of the Cumberlands,Kentucky,KY,Private,Private,4 Year,9000,23000,32000,23000,39800,73800,18,310,95,2,30,19,5262,5736
University of the Ozarks,Arkansas,AR,Private,Private,4 Year,7400,24230,31630,24230,42300,74500,4,33,86,0,1,22,441,587
University of Toledo,Ohio,OH,Public,Public,4 Year,11434,9795,21229,19133,51800,92500,36,2455,836,15,594,480,16210,20626
University of Tulsa,Oklahoma,OK,Private,Private,4 Year,11116,41509,52625,41509,58700,107200,240,183,189,4,128,68,3870,4682
University of Utah,Utah,UT,Public,Public,4 Year,10262,9222,19484,29215,54800,102600,126,401,2718,171,1590,989,25520,31515
University of Vermont,Vermont,VT,Public,Public,4 Year,12462,18276,30738,42516,53200,99400,32,166,533,4,388,331,11402,12856
University of West Alabama,Alabama,AL,Public,Public,4 Year,8116,10040,18156,18490,42700,76100,18,1769,59,2,6,39,2096,3989
University of West Georgia,Georgia,GA,Public,Public,4 Year,10918,7292,18210,20774,46700,82700,17,4286,497,14,131,358,6903,12206
University of Wisconsin-Parkside,Wisconsin,WI,Public,Public,4 Year,8026,7529,15555,15518,46000,81400,9,384,560,9,135,165,3281,4543
University of Wisconsin-Stout,Wisconsin,WI,Public,Public,4 Year,6924,9457,16381,17423,50400,89500,28,156,220,14,307,155,8514,9394
University of Wyoming,Wyoming,WY,Public,Public,4 Year,10320,5400,15720,17490,52400,98800,72,121,749,33,171,305,11369,12820
Valdosta State University,Georgia,GA,Public,Public,4 Year,8110,7476,15586,20958,43400,81000,33,3858,485,14,129,341,6703,11563
Valley City State University,North Dakota,ND,Public,Public,4 Year,6446,7626,14072,17166,39900,68600,12,43,58,2,7,37,1219,1378
Valparaiso University,Indiana,IN,Private,Private,4 Year,11860,40260,52120,40260,53300,98000,15,283,329,1,87,91,3701,4507
Vanderbilt University,Tennessee,TN,Private,Private,4 Year,16234,49816,66050,49816,65400,119100,35,932,810,12,966,456,9475,12686
Vermont Technical College,Vermont,VT,Public,Public,4 Year,10598,15108,25706,27780,52400,93900,11,23,23,0,18,36,1431,1542
Villanova University,Pennsylvania,PA,Private,Private,4 Year,14020,53308,67328,53308,65100,119500,12,580,699,9,666,209,8560,10735
Virginia Commonwealth University,Virginia,VA,Public,Public,4 Year,10428,14490,24918,35138,49900,88200,84,4798,2002,51,3615,1282,19016,30848
Virginia Military Institute,Virginia,VA,Public,Public,4 Year,9428,18862,28290,45706,65900,120600,6,86,82,13,75,28,1410,1700
Virginia State University,Virginia,VA,Public,Public,4 Year,11208,9056,20264,19576,44900,81800,15,4283,99,1,23,0,604,5025
Viterbo University,Wisconsin,WI,Private,Private,4 Year,9060,27970,37030,27970,46800,81900,9,46,61,1,40,45,2602,2804
Wabash College,Indiana,IN,Private,Private,4 Year,10050,43450,53500,43450,62200,114400,5,55,59,1,12,27,767,926
Wake Forest University,North Carolina,NC,Private,Private,4 Year,16032,53322,69354,53322,60700,114800,21,647,433,40,331,166,6150,7788
Walla Walla University,Washington,WA,Private,Private,4 Year,4275,28035,32310,28035,53700,97800,22,55,234,8,122,5,1441,1887
Wartburg College,Iowa,IA,Private,Private,4 Year,9996,41280,51276,41280,49300,88000,1,80,42,1,20,36,1481,1661
Washburn University,Kansas,KS,Public,Public,4 Year,8237,8870,17107,19940,47000,83000,39,327,465,6,76,220,5589,6722
Washington State University,Washington,WA,Public,Public,4 Year,11398,11581,22979,26365,55900,103700,169,896,3077,100,1497,1863,21084,28686
Wayne State College,Nebraska,NE,Public,Public,4 Year,7668,6989,14657,12299,40600,73400,25,95,229,2,19,55,3045,3470
Wayne State University,Michigan,MI,Public,Public,4 Year,10427,13347,23774,28241,50800,91700,82,4881,983,35,2057,689,18851,27578
Webb Institute,New York,NY,Private,Private,4 Year,15050,50175,65225,50175,80800,141800,0,0,0,0,8,4,78,90
Weber State University,Utah,UT,Public,Public,4 Year,6279,5831,12110,16585,53900,94000,95,320,2430,98,317,425,22269,25954
Webster University,Missouri,MO,Private,Private,4 Year,11050,27900,38950,27900,46500,83500,75,6217,1159,31,423,314,8550,16769
Wellesley College,Massachusetts,MA,Private,Private,4 Year,16468,53732,70200,53732,58900,106200,1,128,205,0,538,138,1313,2323
Wentworth Institute of Technology,Massachusetts,MA,Private,Private,4 Year,14190,33950,48140,33950,62700,112700,10,212,155,0,285,247,3649,4558
West Liberty University,West Virginia,WV,Public,Public,4 Year,9406,7730,17136,15670,42500,77000,7,120,21,1,19,31,2495,2694
West Virginia State University,West Virginia,WV,Public,Public,4 Year,11892,8167,20059,16072,41800,76000,14,277,14,0,10,0,2569,2884
West Virginia University,West Virginia,WV,Public,Public,4 Year,10918,8856,19774,24950,54400,99900,42,1232,935,25,545,867,25529,29175
West Virginia University Institute of Technology,West Virginia,WV,Public,Public,4 Year,11390,7464,18854,18648,57100,103700,5,83,54,0,18,32,1069,1261
West Virginia Wesleyan College,West Virginia,WV,Private,Private,4 Year,8856,31640,40496,31640,47000,85200,5,122,27,3,3,43,1308,1511
Western Carolina University,North Carolina,NC,Public,Public,4 Year,9682,4220,13902,8220,44700,77700,87,669,496,12,134,320,8664,10382
Western Connecticut State University,Connecticut,CT,Public,Public,4 Year,13072,10819,23891,22059,51700,88100,13,668,900,10,200,67,4094,5952
Western Kentucky University,Kentucky,KY,Public,Public,4 Year,8343,10602,18945,26496,45500,83100,46,1938,515,18,210,444,17000,20171
Western Michigan University,Michigan,MI,Public,Public,4 Year,10143,12483,22626,15373,50900,92200,106,2634,1117,28,388,696,18945,23914
Western New England University,Massachusetts,MA,Private,Private,4 Year,13590,36804,50394,36804,56400,103000,10,234,273,2,147,42,3214,3922
Western New Mexico University,New Mexico,NM,Public,Public,4 Year,9136,6824,15960,15231,41700,76700,100,145,1442,5,46,17,1802,3557
Western Oregon University,Oregon,OR,Public,Public,4 Year,10415,9540,19955,26415,44500,79300,122,190,469,146,201,16,4905,6049
Western State Colorado University,Colorado,CO,Public,Public,4 Year,9635,10114,19749,21586,44800,81500,15,59,237,14,21,74,2164,2584
Western Washington University,Washington,WA,Public,Public,4 Year,11466,8132,19598,23544,55000,99300,65,224,1095,28,971,1164,11513,15060
Wheeling Jesuit University,West Virginia,WV,Private,Private,4 Year,9900,29290,39190,29290,44800,83400,4,70,31,2,19,25,1424,1575
Whitman College,Washington,WA,Private,Private,4 Year,13174,51764,64938,51764,54600,102600,5,14,117,0,80,85,1197,1498
Whitworth University,Washington,WA,Private,Private,4 Year,11496,43640,55136,43640,49900,88800,19,51,205,12,90,133,2144,2654
Wichita State University,Kansas,KS,Public,Public,4 Year,11252,8271,19523,17452,48700,87300,118,829,1289,14,940,435,11370,14995
Widener University,Pennsylvania,PA,Private,Private,4 Year,14446,45948,60394,45948,55700,100100,17,731,230,6,173,117,3638,4912
Willamette University,Oregon,OR,Private,Private,4 Year,12440,50074,62514,50074,52200,97700,33,53,270,9,189,198,2028,2780
William Carey University,Mississippi,MS,Private,Private,4 Year,6810,12600,19410,12600,41100,71800,17,1096,59,0,119,0,2645,3936
William Jewell College,Missouri,MO,Private,Private,4 Year,9930,34400,44330,34400,51400,94500,4,59,36,2,10,60,889,1060
William Paterson University of New Jersey,New Jersey,NJ,Public,Public,4 Year,11445,13060,24505,21260,50500,90200,11,1483,2740,25,704,250,5835,11048
William Penn University,Iowa,IA,Private,Private,4 Year,6952,25600,32552,25600,43900,78300,10,290,135,6,24,29,1297,1791
Williams College,Massachusetts,MA,Private,Private,4 Year,14500,55450,69950,55450,67500,127500,3,147,243,0,223,146,1364,2126
Winona State University,Minnesota,MN,Public,Public,4 Year,9010,9425,18435,15348,49700,86800,9,199,208,5,161,176,7926,8684
Winthrop University,South Carolina,SC,Public,Public,4 Year,9312,15590,24902,29846,44300,79700,23,1650,217,7,71,147,3909,6024
Wisconsin Lutheran College,Wisconsin,WI,Private,Private,4 Year,10190,29725,39915,29725,46200,82500,7,63,56,1,13,26,1013,1179
Wittenberg University,Ohio,OH,Private,Private,4 Year,10356,39500,49856,39500,52400,105400,3,127,62,1,24,95,1652,1964
Wofford College,South Carolina,SC,Private,Private,4 Year,12685,43845,56530,43845,51300,96600,3,125,54,3,47,53,1373,1658
Worcester Polytechnic Institute,Massachusetts,MA,Private,Private,4 Year,14774,50530,65304,50530,73600,135500,5,130,394,0,294,168,5390,6381
Xavier University of Louisiana,Louisiana,LA,Private,Private,4 Year,9047,24488,33535,24488,46700,88200,4,2088,77,0,384,78,345,2976
Yale University,Connecticut,CT,Private,Private,4 Year,16000,53430,69430,53430,70300,138300,49,675,939,5,1581,547,8540,12336
Yeshiva University,New York,NY,Private,Private,4 Year,12250,43500,55750,43500,63500,112800,6,144,199,15,289,29,5666,6348
