university name,American Indian,Black,Hispanic,Pacific Islander,Asian,2+ races,Other,Total Enrollment
Adams State University,37,191,812,10,37,126,1941,3154
Agnes Scott College,1,288,78,2,41,52,411,873
Alabama State University,8,4950,68,3,20,56,414,5519
Alaska Pacific University,87,13,15,4,10,41,409,579
Albany College of Pharmacy and Health Sciences,4,59,63,2,228,16,1191,1563
Albertus Magnus College,6,515,217,2,7,20,783,1550
Albion College,3,47,46,1,23,33,1115,1268
Alcorn State University,3,3386,12,11,10,57,160,3639
Allen College,0,13,2,2,7,5,546,575
Alma College,9,46,51,1,21,36,1232,1396
Amherst College,6,222,235,1,234,81,1013,1792
Andrews University,10,702,458,13,315,71,1849,3418
Appalachian State University,44,584,702,11,267,441,15977,18026
Arizona Christian University,7,55,114,5,18,34,504,737
Arkansas Tech University,121,919,728,8,154,309,9763,12002
Asbury University,4,92,40,5,14,99,1625,1879
Auburn University,183,1886,599,0,601,0,22643,25912
Auburn University at Montgomery,23,1633,36,9,104,136,3116,5057
Augusta University,25,1687,398,22,500,328,5028,7988
Austin Peay State University,40,1902,575,19,157,514,6904,10111
Avila University,14,359,125,5,31,43,1330,1907
Babson College,4,119,244,2,274,58,2348,3049
Baker University,54,281,147,11,43,39,2382,2957
Ball State University,26,1378,692,24,215,411,17909,20655
Barnard College,1,168,286,1,367,133,1617,2573
Barry University,28,2090,2032,12,182,87,4087,8518
Barton College,9,245,55,0,12,28,686,1035
Bastyr University,6,43,42,0,121,73,917,1202
Bates College,4,85,120,0,82,72,1410,1773
Baylor University,62,1129,2146,9,939,699,11279,16263
Belhaven University,23,2253,144,7,20,61,1606,4114
Bellarmine University,9,196,101,5,65,97,3136,3609
Bellevue University,49,1168,676,30,214,211,7531,9879
Belmont Abbey College,4,391,23,0,15,5,1122,1560
Belmont University,16,318,300,7,157,231,6215,7244
Beloit College,5,60,109,3,32,22,1072,1303
Benedict College,0,2416,7,0,9,0,12,2444
Benedictine College,8,70,112,7,26,95,1820,2138
Bennington College,13,10,38,1,25,23,645,755
Bentley University,4,149,325,0,433,102,4552,5565
Berea College,2,242,95,3,26,88,1165,1621
Berry College,2,93,134,3,26,62,1857,2177
Black Hills State University,154,41,166,10,22,143,3953,4489
Bloomfield College,12,1044,484,8,56,11,389,2004
Boise State University,132,357,2149,71,436,697,18385,22227
Boston College,15,575,1238,1,1144,375,10969,14317
Boston University,27,1190,2419,34,3448,868,24126,32112
Bowdoin College,2,88,229,0,114,117,1255,1805
Bowie State University,6,4751,147,9,81,168,533,5695
Bradley University,10,245,282,5,144,69,4545,5300
Brandeis University,6,275,323,3,582,118,4638,5945
Brescia University,9,133,63,2,3,0,846,1056
Brown University,26,550,894,13,1099,376,6223,9181
Bryant University,12,145,216,5,141,44,2899,3462
Bucknell University,1,114,187,0,126,124,3072,3624
Butler University,8,182,146,0,119,91,4302,4848
California Institute of Technology,4,27,173,1,580,68,1356,2209
Calvin College,16,94,129,0,173,111,3470,3993
Cameron University,296,861,644,36,93,427,3180,5537
Campbell University,40,946,343,9,193,112,4458,6101
Campbellsville University,6,375,56,4,17,41,2928,3427
Cardinal Stritch University,18,842,293,8,76,71,2503,3811
Carleton College,3,79,130,2,184,93,1566,2057
Carnegie Mellon University,9,402,574,2,2071,334,9195,12587
Carroll College,18,11,71,4,21,23,1292,1440
Carroll University,2,37,190,3,116,68,3030,3446
Carson-Newman University,3,153,34,0,13,0,2159,2362
Carthage College,12,153,126,7,33,71,2546,2948
Case Western Reserve University,14,563,444,5,1543,269,7933,10771
Catawba College,12,265,48,0,15,28,932,1300
Centenary College of Louisiana,6,88,35,1,21,22,446,619
Central Baptist College,12,175,33,1,2,12,623,858
Central Christian College of Kansas,19,210,107,5,11,17,796,1165
Central College,5,26,44,2,15,14,1305,1411
Central Connecticut State University,23,1225,1359,11,429,290,8700,12037
Central Michigan University,181,3016,901,24,317,604,21836,26879
Central Washington University,65,365,1430,137,532,710,8560,11799
Centre College,0,64,32,2,46,42,1201,1387
Chadron State College,36,116,180,11,25,83,2582,3033
Chaminade University of Honolulu,24,152,162,429,726,265,998,2756
Champlain College,15,97,137,2,54,203,3077,3585
Charleston Southern University,18,926,108,4,41,67,2203,3367
Christian Brothers University,5,522,99,1,84,39,917,1667
Christopher Newport University,15,414,258,5,125,251,4153,5221
Claremont McKenna College,1,54,154,1,142,101,871,1324
Clark Atlanta University,14,2930,14,0,14,0,513,3485
Clark University,3,121,169,2,179,59,2890,3423
Clarke University,1,33,44,0,9,16,1097,1200
Clarkson College,7,53,36,2,29,19,1075,1221
Clarkson University,10,77,170,1,122,73,3420,3873
Cleary University,0,41,12,0,14,0,470,537
Clemson University,41,1347,593,14,389,465,19008,21857
Cleveland State University,26,2927,731,18,504,435,12295,16936
Coastal Carolina University,40,1904,348,13,77,405,7189,9976
Coe College,3,71,109,1,33,45,1174,1436
Colby College,3,56,113,0,103,98,1474,1847
Colby-Sawyer College,3,88,41,1,21,7,1208,1369
Colgate University,2,120,243,3,103,101,2316,2888
College for Creative Studies,3,130,54,4,61,54,1153,1459
College of Charleston,21,823,478,13,181,401,9539,11456
College of Saint Mary,5,63,102,1,17,25,805,1018
College of the Holy Cross,5,110,296,1,141,98,2136,2787
Colorado Christian University,36,391,623,16,157,227,4337,5787
Colorado College,9,48,184,0,94,173,1559,2067
Colorado Mesa University,68,218,1389,55,126,313,6947,9116
Colorado School of Mines,13,52,417,3,231,244,5002,5962
Columbia International University,3,198,28,0,34,20,820,1103
Columbus State University,35,2921,430,20,176,182,4428,8192
Connecticut College,0,62,163,0,67,52,1556,1900
Converse College,0,100,56,0,4,38,1191,1389
Corban University,10,18,34,7,24,72,960,1125
Cornell College,4,55,140,3,26,46,812,1086
Cornell University,64,1059,1994,15,3129,762,14656,21679
Cornish College of the Arts,6,29,76,2,43,63,548,767
Covenant College,4,32,34,2,22,23,1056,1173
Creighton University,36,330,472,25,742,259,6372,8236
Cumberland University,5,181,37,0,14,0,1244,1481
Dakota State University,25,144,115,6,61,75,2621,3047
Dakota Wesleyan University,9,15,23,0,2,18,803,870
Dartmouth College,102,341,446,7,775,245,4382,6298
Davidson College,11,114,117,0,102,71,1355,1770
Delaware State University,12,2916,226,5,47,160,1031,4397
Delta State University,4,1325,45,5,24,23,2188,3614
Denison University,1,158,229,2,84,80,1724,2278
DePaul University,19,2123,3388,37,1777,795,15660,23799
DePauw University,6,126,76,0,75,144,1788,2215
Dickinson College,1,97,142,1,55,80,1988,2364
Dickinson State University,14,60,66,4,9,38,1288,1479
Dillard University,0,1108,6,0,0,9,77,1200
Dordt College,3,22,12,103,13,0,1306,1459
Drake University,10,160,163,1,200,79,4449,5062
Drew University,4,249,204,2,105,52,1497,2113
Drexel University,40,2055,1424,108,3083,691,18958,26359
Drury University,41,159,206,7,48,84,3670,4215
Duke University,66,1156,797,20,2268,369,11180,15856
East Carolina University,181,4359,1498,26,782,788,19877,27511
East Tennessee State University,38,860,290,9,232,341,12664,14434
Eastern Connecticut State University,16,346,482,6,151,137,4149,5287
Eastern Kentucky University,49,967,333,19,142,357,14438,16305
Eastern Michigan University,52,4059,830,15,565,704,16176,22401
Eastern Oregon University,83,99,229,36,77,47,3082,3653
Eastern Washington University,167,432,1772,37,395,604,10046,13453
Eckerd College,7,101,163,4,35,60,1713,2083
Edgewood College,11,82,152,4,73,66,2592,2980
Elon University,29,391,316,3,146,110,5488,6483
Emory University,26,1474,874,8,2281,338,9768,14769
Emporia State University,29,272,339,7,52,286,5129,6114
Erskine College,3,125,22,0,6,0,597,753
Fairfield University,3,137,352,5,113,67,4446,5123
Fairmont State University,15,214,76,3,18,96,3613,4035
Faulkner University,24,1505,71,3,19,52,1661,3335
Felician University,10,382,486,11,134,12,918,1953
Ferris State University,78,1013,556,7,207,443,12296,14600
Ferrum College,6,436,77,3,8,69,852,1451
Fisk University,0,653,18,1,6,12,82,772
Florida Atlantic University,57,5678,7255,36,1318,924,15029,30297
Florida Institute of Technology,28,533,359,17,174,97,5185,6393
Florida International University,42,5977,31211,57,1434,1042,9847,49610
Florida State University,116,3377,6594,59,1029,1063,28988,41226
Fordham University,18,959,1879,15,1164,420,10776,15231
Fort Hays State University,56,514,877,15,130,281,11952,13825
Fort Lewis College,887,31,388,8,24,227,2226,3791
Francis Marion University,11,1778,56,2,47,38,2012,3944
Franklin Pierce University,10,81,40,3,36,63,2042,2275
Freed-Hardeman University,4,230,38,0,10,28,1557,1867
Friends University,25,204,68,7,51,118,1409,1882
Frostburg State University,6,1466,244,5,99,223,3602,5645
George Fox University,24,68,263,19,133,172,3107,3786
George Mason University,72,3153,3420,122,5001,1209,20752,33729
Georgetown College,3,105,38,0,11,34,1071,1262
Georgia Southern University,89,5249,1235,22,280,383,13259,20517
Georgia State University,62,11875,2651,27,3386,1335,13220,32556
Gettysburg College,1,87,113,0,45,70,2131,2447
Goddard College,2,19,24,2,10,9,472,538
Goldey-Beacom College,4,215,28,0,55,26,1684,2012
Gonzaga University,57,119,561,27,289,307,5992,7352
Goucher College,5,218,137,1,55,62,1642,2120
Grambling State University,13,4088,41,2,10,56,294,4504
Green Mountain College,8,34,28,0,7,9,747,833
Grinnell College,3,100,134,0,128,74,1295,1734
Gustavus Adolphus College,2,46,81,1,97,86,2144,2457
Hamline University,25,190,180,5,180,131,3758,4469
Hampden-Sydney College,5,85,23,0,20,60,912,1105
Hampton University,6,3921,50,0,71,1,344,4393
Hanover College,7,55,26,0,16,21,1020,1145
Harding University,46,303,158,1,86,87,5378,6059
Harvey Mudd College,4,13,80,0,167,50,490,804
Hastings College,6,41,67,4,16,33,1045,1212
Haverford College,4,69,102,0,100,70,849,1194
Hawaii Pacific University,24,345,764,128,921,987,2658,5827
Henderson State University,7,846,147,0,23,152,2452,3627
Hendrix College,22,65,65,1,77,9,1119,1358
High Point University,21,246,173,0,61,167,3731,4399
Hofstra University,31,909,1254,78,893,198,7590,10953
Holy Cross College,2,49,56,1,8,18,386,520
Hood College,1,255,138,0,78,73,1820,2365
Hope College,3,85,258,0,54,67,2988,3455
Huntingdon College,14,229,29,2,9,30,847,1160
Husson University,16,147,46,7,73,39,3087,3415
Idaho State University,141,156,1122,28,179,311,11492,13429
Illinois Institute of Technology,12,292,600,13,497,72,6412,7898
Illinois State University,24,1454,1711,18,434,478,16496,20615
Illinois Wesleyan University,5,87,128,1,82,43,1547,1893
Indiana State University,36,2199,395,8,179,374,9992,13183
Iowa State University,80,891,1451,31,940,672,30370,34435
Jackson State University,39,8491,38,1,43,96,800,9508
Jacksonville State University,61,2030,110,7,50,0,6401,8659
Jacksonville University,14,607,277,8,70,113,2996,4085
James Madison University,31,863,1043,39,889,709,17281,20855
Jefferson College of Health Sciences,1,82,40,0,28,14,966,1131
John Brown University,51,108,152,3,34,103,2399,2850
John Carroll University,2,186,110,0,62,77,3251,3688
Johns Hopkins University,35,1419,1498,27,2919,690,14784,21372
Kalamazoo College,2,76,135,3,86,70,1089,1461
Kansas State University,94,954,1419,36,381,695,21187,24766
Kansas Wesleyan University,4,43,89,2,8,14,550,710
Kean University,19,2802,3443,48,802,244,7001,14359
Keene State College,14,48,156,2,56,97,4584,4957
Kennesaw State University,60,4845,1862,39,861,1018,17029,25714
Kentucky Christian University,2,56,8,0,4,7,581,658
Kentucky State University,3,1007,33,4,10,40,798,1895
Kentucky Wesleyan College,1,102,12,0,3,0,591,709
Kenyon College,9,58,100,0,87,59,1349,1662
Kettering College,2,35,25,1,35,15,647,760
Kettering University,4,91,71,2,61,48,1802,2079
Knox College,3,110,175,0,77,56,978,1399
La Salle University,16,1078,462,7,286,349,4044,6242
Lafayette College,3,118,166,1,81,53,2081,2503
Lake Forest College,4,108,243,0,81,57,1133,1626
Lake Superior State University,208,80,58,0,13,0,2048,2407
Lamar University,55,3532,2070,10,478,258,8492,14895
Lander University,4,858,36,2,42,55,1790,2787
Langston University,37,1969,31,0,0,0,445,2482
Lawrence Technological University,13,234,100,1,925,0,2742,4015
Lawrence University,8,51,100,0,60,59,1233,1511
Lehigh University,7,239,475,1,479,139,5779,7119
Lenoir-Rhyne University,12,266,60,1,30,52,1629,2050
LeTourneau University,10,278,227,2,28,99,2023,2667
Lewis & Clark College,55,74,287,10,226,28,2824,3504
Lewis University,8,610,1043,14,204,149,4661,6689
Lewis-Clark State College,99,33,215,13,39,102,3803,4304
Limestone College,9,1521,92,1,11,13,1567,3214
Lindenwood University,46,2019,374,21,58,307,9326,12151
Lindsey Wilson College,12,253,26,1,17,33,2299,2641
Lipscomb University,4,371,225,4,119,66,3700,4489
Longwood University,15,415,229,6,73,164,4194,5096
Loras College,1,39,89,2,13,22,1403,1569
Louisiana College,10,280,40,1,12,12,901,1256
Louisiana Tech University,43,1441,123,16,131,190,9281,11225
Loyola Marymount University,18,585,2190,8,1054,616,5044,9515
Loyola University Chicago,15,920,1793,33,1449,721,10971,15902
Loyola University Maryland,12,465,470,5,190,135,4690,5967
Loyola University New Orleans,32,655,541,3,143,133,2823,4330
Luther College,8,34,80,0,39,49,2175,2385
Lyndon State College,13,49,48,1,11,28,1280,1430
Lyon College,10,47,44,0,11,0,600,712
Macalester College,1,49,123,1,146,111,1642,2073
Maharishi University of Management,3,94,43,0,25,22,1267,1454
Maine College of Art,0,7,27,0,10,22,393,459
Maine Maritime Academy,3,6,8,2,7,0,1034,1060
Manchester University,2,86,67,0,61,43,1229,1488
Manhattan Christian College,5,8,9,0,1,3,285,311
Manhattan College,7,138,701,0,151,72,2901,3970
Marietta College,2,69,38,0,20,32,1339,1500
Marquette University,29,463,950,11,527,329,9436,11745
Marshall University,47,738,231,10,157,268,11930,13381
Maryland Institute College of Art,3,137,140,3,259,116,1604,2262
Marymount University,17,500,451,17,274,109,2073,3441
Maryville College,9,135,34,2,14,32,987,1213
Maryville University of Saint Louis,39,577,219,13,164,142,4777,5931
Massachusetts Institute of Technology,18,344,1087,1,1832,415,7622,11319
Massachusetts Maritime Academy,18,33,42,1,38,10,1355,1497
Mayville State University,19,70,51,5,2,32,902,1081
McDaniel College,15,336,133,3,89,0,2630,3206
McNeese State University,53,1421,211,6,121,172,6253,8237
McPherson College,2,82,74,4,4,18,475,659
MCPHS University,7,330,184,8,1469,24,4913,6935
Menlo College,6,55,166,21,56,55,435,794
Mercer University,45,2550,330,12,566,144,4905,8552
Merrimack College,3,99,177,0,45,47,2966,3337
Methodist University,20,454,186,5,37,83,1676,2461
Michigan State University,127,3196,1878,46,2214,1217,41403,50081
Michigan Technological University,33,95,117,8,82,156,6608,7099
Mid-America Christian University,105,743,180,10,14,100,1536,2688
MidAmerica Nazarene University,13,203,104,11,28,23,1488,1870
Middle Tennessee State University,71,4407,917,22,589,647,16076,22729
Middlebury College,7,73,220,0,170,118,1945,2533
Midland University,5,68,38,6,10,92,1143,1362
Miles College,0,1732,5,1,0,10,34,1782
Milligan College,3,46,52,2,15,19,1027,1164
Millsaps College,6,89,18,0,35,6,688,842
Milwaukee School of Engineering,6,72,125,13,86,41,2467,2810
Minneapolis College of Art and Design,7,31,48,0,57,0,640,783
Minot State University,52,167,167,13,46,100,2865,3410
Mississippi College,26,1164,124,5,118,52,3495,4984
Mississippi State University,104,3871,457,17,263,273,15153,20138
Mississippi University for Women,6,987,20,2,41,12,1628,2696
Mississippi Valley State University,1,2033,25,0,13,0,150,2222
Missouri University of Science and Technology,30,290,256,14,226,167,7657,8640
Monmouth University,8,351,585,7,215,127,5102,6395
Montana Tech of the University of Montana,35,23,34,0,20,1,1972,2085
Montclair State University,13,1946,4447,38,1015,637,11926,20022
Morehead State University,20,409,162,12,41,142,10266,11052
Morehouse College,1,1988,13,0,1,4,102,2109
Morningside College,10,29,87,5,14,29,2649,2823
Mount Carmel College of Nursing,4,64,20,2,15,24,955,1084
Mount Marty College,29,34,64,5,13,0,1091,1236
Mount Mercy University,6,74,24,2,25,25,1606,1762
Muhlenberg College,4,74,155,0,64,36,2107,2440
Multnomah University,6,28,46,4,9,30,630,753
Murray State University,22,776,196,6,99,171,9937,11207
Nebraska Wesleyan University,6,60,92,2,38,30,1855,2083
New College of Florida,1,22,127,0,20,38,626,834
New England College,11,411,148,0,48,20,1761,2399
New England Institute of Technology,19,133,283,2,51,29,2405,2922
New Jersey City University,19,1624,2623,0,660,98,3112,8136
New Jersey Institute of Technology,6,899,1749,3,1901,267,5821,10646
New Mexico Highlands University,233,163,1891,18,29,43,1169,3546
New Mexico Institute of Mining and Technology,54,46,522,2,67,71,1365,2127
New York University,94,2374,4267,45,7314,1248,33932,49274
Newberry College,4,283,48,1,7,32,718,1093
Newman University,45,140,362,7,180,93,2860,3687
Nicholls State University,117,1242,197,4,70,176,4486,6292
North Carolina Wesleyan College,18,895,38,0,11,32,878,1872
North Central College,3,118,276,2,66,79,2499,3043
Northeastern State University,1754,360,338,9,167,1138,4544,8310
Northeastern University,10,624,1103,7,1753,597,15704,19798
Northern Arizona University,838,888,5368,62,468,1337,18744,27705
Northern Illinois University,30,2825,2531,22,984,569,13650,20611
Northern Kentucky University,55,996,379,17,166,252,13225,15090
Northern State University,55,49,79,6,31,52,3259,3531
Northwest Christian University,18,16,57,3,15,24,572,705
Northwest Missouri State University,20,374,182,8,39,167,5930,6720
Northwest Nazarene University,14,37,175,9,27,44,1943,2249
Northwestern Oklahoma State University,137,136,150,10,15,11,1707,2166
Northwestern University,22,1058,1662,12,2865,702,15233,21554
Norwich University,14,200,249,12,85,144,2968,3672
Notre Dame of Maryland University,22,631,113,6,188,0,1804,2764
Nova Southeastern University,42,5374,6150,13,1491,428,10650,24148
Oakland University,79,1601,565,17,955,492,16810,20519
Oakwood University,11,1629,47,0,9,0,243,1939
Oberlin College,3,154,215,2,124,168,2312,2978
Oglethorpe University,3,202,113,0,43,29,704,1094
Ohio Northern University,4,113,40,3,56,105,3374,3695
Ohio Wesleyan University,1,116,72,0,40,79,1426,1734
Oklahoma Baptist University,107,118,45,5,17,159,1528,1979
Oklahoma Christian University,48,308,142,1,203,153,1620,2475
Oklahoma City University,87,162,203,1,74,200,2308,3035
Oklahoma Panhandle State University,43,135,211,0,17,34,858,1298
Oklahoma Wesleyan University,97,88,96,3,5,55,1001,1345
Old Dominion University,89,5980,1578,98,995,1319,14873,24932
Oral Roberts University,113,565,273,0,80,154,2296,3481
Oregon Institute of Technology,49,58,357,27,232,214,3323,4260
Oregon State University,172,395,2101,98,1901,1653,22566,28886
Ouachita Baptist University,11,129,58,1,13,0,1289,1501
Pacific Lutheran University,28,95,249,24,218,233,2395,3242
Pacific Northwest College of Art,7,5,27,1,12,62,405,519
Pacific University,24,58,288,56,507,267,2440,3640
Park University,80,2014,1337,48,267,307,6739,10792
Peru State College,15,182,130,7,31,68,2066,2499
Pfeiffer University,6,460,57,1,24,20,1216,1784
Philander Smith College,1,512,2,1,3,11,37,567
Pittsburg State University,104,273,312,10,56,333,6391,7479
Plymouth State University,13,101,122,0,100,61,4458,4855
Pomona College,4,109,232,2,213,122,968,1650
Portland State University,376,886,2664,164,2024,1314,20268,27696
Prairie View A&M University,25,7087,229,8,243,58,779,8429
Presbyterian College,4,199,28,1,45,23,1160,1460
Prescott College,22,24,21,2,12,39,728,848
Princeton University,10,474,571,7,1282,281,5463,8088
Providence College,8,189,318,9,51,77,3881,4533
Queens University of Charlotte,9,385,120,1,54,27,1652,2248
Quinnipiac University,20,463,694,6,291,140,7421,9035
Radford University,27,1101,499,20,143,435,7573,9798
Ramapo College of New Jersey,16,319,781,11,377,70,4429,6003
Randolph College,4,74,31,0,20,24,540,693
Reed College,4,26,146,3,80,113,1022,1394
Regis University,57,521,1392,21,428,234,6555,9208
Rensselaer Polytechnic Institute,6,182,439,3,629,386,5190,6835
Rhode Island College,32,639,1153,10,249,144,6414,8641
Rhode Island School of Design,3,50,189,2,386,86,1733,2449
Rhodes College,6,128,73,0,133,62,1652,2054
Rice University,5,340,746,6,1102,222,4200,6621
Rider University,8,529,528,8,235,118,3868,5294
Ripon College,2,19,40,0,12,15,752,840
Roanoke College,7,110,76,2,30,85,1740,2050
Rockhurst University,5,146,143,3,91,79,2535,3002
Rocky Mountain College,21,32,18,5,10,67,854,1007
Roger Williams University,42,117,238,3,107,4,4373,4884
Rogers State University,510,94,181,4,49,709,2483,4030
Rollins College,9,197,487,2,95,91,2326,3207
Rose-Hulman Institute of Technology,3,57,68,2,82,90,2086,2388
Rowan University,35,1342,1301,13,814,317,10956,14778
Rust College,0,924,0,0,2,0,37,963
Sacred Heart University,14,361,497,11,174,89,6635,7781
Saginaw Valley State University,32,950,336,4,72,162,8273,9829
Saint Anselm College,3,36,57,2,12,34,1824,1968
Saint Joseph's College of Maine,13,96,63,1,39,0,2721,2933
Saint Louis University,13,1091,567,0,1111,699,13571,17052
Saint Martin's University,9,109,181,38,80,123,1261,1801
Saint Mary's College of California,13,212,918,24,414,221,2310,4112
Saint Michael's College,5,51,98,1,43,43,2377,2618
Saint Peter's University,24,819,950,14,235,57,1203,3302
Saint Xavier University,12,668,920,2,112,71,2288,4073
Salisbury University,34,1091,345,10,216,306,6768,8770
Salve Regina University,12,67,163,2,34,47,2414,2739
Samford University,17,372,218,1,80,50,4195,4933
San Jose State University,44,1029,7407,242,10381,1559,12051,32713
Santa Clara University,10,238,1283,20,1416,461,5587,9015
Savannah College of Art and Design,61,1270,859,27,511,16,8603,11347
Seattle Pacific University,19,152,334,11,430,292,2979,4217
Seattle University,41,215,612,43,1011,457,4894,7273
Seton Hall University,10,1098,1364,30,688,189,6248,9627
Shenandoah University,53,411,182,12,269,0,2766,3693
Shepherd University,26,321,111,3,74,35,3471,4041
Shorter University,8,356,53,2,13,28,1106,1566
Sierra Nevada College,31,41,33,10,19,3,902,1039
Smith College,5,149,276,2,348,128,2081,2989
South Carolina State University,4,3128,18,1,22,1,157,3331
South Dakota School of Mines and Technology,50,50,110,5,44,96,2443,2798
South Dakota State University,127,255,241,13,140,229,11538,12543
Southeast Missouri State University,55,1022,189,4,118,13,10686,12087
Southeastern Louisiana University,35,2148,893,14,128,757,10512,14487
Southeastern Oklahoma State University,698,208,154,7,37,522,2252,3878
Southern Adventist University,13,380,604,19,228,105,1826,3175
Southern Connecticut State University,19,1539,1114,2,271,230,7650,10825
Southern Methodist University,31,669,1172,15,671,291,8423,11272
Southern Nazarene University,93,318,134,8,55,70,1576,2254
Southern New Hampshire University,152,2373,1009,33,337,60,39310,43274
Southern Oregon University,71,116,477,26,124,274,4866,5954
Southern University at New Orleans,3,1771,13,0,10,0,306,2103
Southern Vermont College,4,59,43,1,3,7,340,457
Southern Wesleyan University,5,483,56,1,10,26,1197,1778
Southwestern Oklahoma State University,210,261,350,6,145,363,3659,4994
Spalding University,3,425,66,5,32,57,1723,2311
Spelman College,3,1855,7,0,2,58,210,2135
Spring Hill College,10,210,77,1,16,45,1017,1376
St. Mary's University,23,142,2060,10,95,8,1374,3712
Stanford University,98,633,1749,30,2630,1142,10681,16963
Stephens College,3,117,31,4,12,48,647,862
Stetson University,16,288,564,1,94,124,3050,4137
Stevens Institute of Technology,5,96,321,0,436,0,5267,6125
Stevenson University,5,1267,194,8,133,114,2601,4322
Stockton University,10,532,848,12,439,239,6490,8570
Stonehill College,1,99,103,1,51,41,1988,2284
Swarthmore College,2,90,206,1,252,120,871,1542
Tabor College,3,64,83,2,5,25,584,766
Taylor University,6,55,63,7,63,15,1937,2146
Tennessee State University,14,5750,112,0,91,276,2784,9027
Tennessee Technological University,17,416,252,4,147,250,10253,11339
Texas Christian University,81,479,1060,29,277,55,8052,10033
Texas Tech University,113,2011,7075,39,850,1053,24017,35158
Thomas More College,2,109,23,1,12,32,1476,1655
Thomas More College of Liberal Arts,0,1,2,0,2,0,88,93
Tougaloo College,1,887,4,0,0,0,8,900
Towson University,33,3456,1196,26,1049,813,15712,22285
Transylvania University,1,31,46,1,20,30,885,1014
Trevecca Nazarene University,9,372,71,3,27,73,2051,2606
Trine University,12,86,148,4,48,74,2459,2831
Trinity University,7,99,454,1,142,108,1621,2432
Troy University,143,6840,666,19,140,486,10747,19041
Truman State University,8,218,173,6,115,157,5571,6248
Tufts University,12,368,594,4,1353,409,8167,10907
Tuskegee University,2,2345,32,0,26,0,698,3103
University of Alabama at Birmingham,46,3943,496,14,931,563,12705,18698
University of Arizona,517,1402,9405,95,2392,1608,26817,42236
University of Arkansas at Little Rock,44,2625,713,0,260,823,7180,11645
University of Arkansas at Monticello,17,1051,130,5,23,72,2556,3854
University of Arkansas at Pine Bluff,3,2295,40,0,15,2,158,2513
University of Bridgeport,27,1315,591,11,170,91,2986,5191
University of Central Arkansas,55,2011,452,11,185,352,8632,11698
University of Central Florida,120,6400,13108,129,3343,1841,35826,60767
University of Central Missouri,26,886,322,10,124,266,11745,13379
University of Central Oklahoma,638,1552,1257,28,510,1257,11598,16840
University of Charleston,19,209,54,2,57,21,1749,2111
University of Chicago,35,634,928,6,1923,336,11235,15097
University of Connecticut,41,1353,1928,16,2320,597,20286,26541
University of Dallas,8,207,386,4,175,68,1700,2548
University of Dayton,9,417,310,3,156,126,10322,11343
University of Delaware,17,1232,1461,21,1018,576,18355,22680
University of Denver,52,406,1023,14,390,328,9596,11809
University of Detroit Mercy,17,504,133,11,242,117,3921,4945
University of Dubuque,11,226,142,4,41,60,1637,2121
University of Evansville,4,72,71,0,38,49,2333,2567
University of Florida,137,3151,8127,240,3501,1108,33195,49459
University of Georgia,37,2805,1637,37,2859,1052,26770,35197
University of Hartford,16,865,612,5,232,146,4941,6817
University of Hawaii at Hilo,20,46,457,391,806,1129,1075,3924
University of Houston,47,4173,10994,97,8118,1218,16267,40914
University of Idaho,113,142,925,22,161,376,9963,11702
University of Illinois at Chicago,29,2194,5435,63,5229,618,14401,27969
University of Illinois at Urbana-Champaign,39,2186,3384,47,6121,1049,32314,45140
University of Indianapolis,8,456,191,8,85,127,4567,5442
University of Iowa,50,853,1730,26,1056,630,25625,29970
University of Jamestown,15,40,48,3,11,0,853,970
University of Kansas,142,1133,1554,22,1081,1096,22152,27180
University of Kentucky,55,1989,1031,26,807,770,24525,29203
University of Louisiana at Lafayette,80,3377,547,15,373,277,12526,17195
University of Louisiana at Monroe,29,1936,176,4,197,176,5999,8517
University of Louisville,34,2247,813,14,749,784,16920,21561
University of Maine,133,212,241,2,144,261,10293,11286
University of Maine at Farmington,13,35,26,2,14,40,1830,1960
University of Maine at Fort Kent,10,34,19,2,6,25,1231,1327
University of Maine at Machias,22,26,24,0,5,10,723,810
University of Maine at Presque Isle,28,12,13,0,4,28,1053,1138
University of Mary,49,77,84,5,32,43,2519,2809
University of Memphis,53,7135,757,26,625,630,11833,21059
University of Miami,23,1169,3526,22,953,408,10573,16674
University of Mississippi,64,3178,610,23,429,471,17728,22503
University of Mobile,26,380,23,0,10,34,1127,1600
University of Montevallo,18,434,93,0,19,68,2438,3070
University of Mount Union,4,122,41,0,15,85,1995,2262
University of New England,27,387,82,15,301,96,5521,6429
University of New Haven,22,602,578,12,169,92,5336,6811
University of New Orleans,33,1375,840,3,656,289,6038,9234
University of North Alabama,62,869,168,5,131,148,5458,6841
University of North Carolina at Chapel Hill,133,2304,1895,70,2410,1326,20997,29135
University of North Carolina at Charlotte,81,4410,2000,30,1343,856,18518,27238
University of North Carolina School of the Arts,5,72,68,2,12,44,755,958
University of North Dakota,253,344,420,15,207,404,13263,14906
University of North Florida,20,1553,1481,12,674,779,11465,15984
University of North Georgia,35,684,1435,17,437,417,13039,16064
University of Northern Colorado,38,437,1772,22,188,377,9216,12050
University of Northern Iowa,25,339,377,7,108,210,10862,11928
University of Notre Dame,21,376,1139,5,573,446,9619,12179
University of Oregon,162,482,2042,99,1280,1328,18703,24096
University of Pennsylvania,21,1483,1799,8,3717,777,17001,24806
University of Pikeville,11,167,45,2,25,0,2208,2458
University of Portland,7,41,408,63,404,337,2883,4143
University of Puget Sound,4,29,191,1,189,248,2164,2826
University of Rhode Island,44,803,1288,6,534,394,13502,16571
University of Richmond,13,345,258,2,215,137,3212,4182
University of Rochester,28,491,533,5,915,241,8847,11060
University of Saint Joseph,2,252,223,3,116,32,1937,2565
University of San Diego,42,291,1505,30,641,408,5432,8349
University of San Francisco,26,464,1919,69,1881,635,5695,10689
University of Science and Arts of Oklahoma,102,37,56,0,9,55,645,904
University of Scranton,6,155,388,2,149,117,4772,5589
University of Sioux Falls,4,46,17,2,8,48,1294,1419
University of South Alabama,100,3285,402,33,539,325,11121,15805
University of South Dakota,168,227,232,51,151,232,9000,10061
University of Southern California,73,2238,5286,104,7696,1380,25676,42453
University of Southern Maine,76,224,147,7,164,169,7641,8428
University of Southern Mississippi,48,4033,457,14,172,316,9752,14792
University of the Cumberlands,18,310,95,2,30,19,5262,5736
University of the Ozarks,4,33,86,0,1,22,441,587
University of Toledo,36,2455,836,15,594,480,16210,20626
University of Tulsa,240,183,189,4,128,68,3870,4682
University of Utah,126,401,2718,171,1590,989,25520,31515
University of Vermont,32,166,533,4,388,331,11402,12856
University of West Alabama,18,1769,59,2,6,39,2096,3989
University of West Georgia,17,4286,497,14,131,358,6903,12206
University of Wisconsin-Parkside,9,384,560,9,135,165,3281,4543
University of Wisconsin-Stout,28,156,220,14,307,155,8514,9394
University of Wyoming,72,121,749,33,171,305,11369,12820
Valdosta State University,33,3858,485,14,129,341,6703,11563
Valley City State University,12,43,58,2,7,37,1219,1378
Valparaiso University,15,283,329,1,87,91,3701,4507
Vanderbilt University,35,932,810,12,966,456,9475,12686
Vermont Technical College,11,23,23,0,18,36,1431,1542
Villanova University,12,580,699,9,666,209,8560,10735
Virginia Commonwealth University,84,4798,2002,51,3615,1282,19016,30848
Virginia Military Institute,6,86,82,13,75,28,1410,1700
Virginia State University,15,4283,99,1,23,0,604,5025
Viterbo University,9,46,61,1,40,45,2602,2804
Wabash College,5,55,59,1,12,27,767,926
Wake Forest University,21,647,433,40,331,166,6150,7788
Walla Walla University,22,55,234,8,122,5,1441,1887
Wartburg College,1,80,42,1,20,36,1481,1661
Washburn University,39,327,465,6,76,220,5589,6722
Washington State University,169,896,3077,100,1497,1863,21084,28686
Wayne State College,25,95,229,2,19,55,3045,3470
Wayne State University,82,4881,983,35,2057,689,18851,27578
Webb Institute,0,0,0,0,8,4,78,90
Weber State University,95,320,2430,98,317,425,22269,25954
Webster University,75,6217,1159,31,423,314,8550,16769
Wellesley College,1,128,205,0,538,138,1313,2323
Wentworth Institute of Technology,10,212,155,0,285,247,3649,4558
West Liberty University,7,120,21,1,19,31,2495,2694
West Virginia State University,14,277,14,0,10,0,2569,2884
West Virginia University,42,1232,935,25,545,867,25529,29175
West Virginia University Institute of Technology,5,83,54,0,18,32,1069,1261
West Virginia Wesleyan College,5,122,27,3,3,43,1308,1511
Western Carolina University,87,669,496,12,134,320,8664,10382
Western Connecticut State University,13,668,900,10,200,67,4094,5952
Western Kentucky University,46,1938,515,18,210,444,17000,20171
Western Michigan University,106,2634,1117,28,388,696,18945,23914
Western New England University,10,234,273,2,147,42,3214,3922
Western New Mexico University,100,145,1442,5,46,17,1802,3557
Western Oregon University,122,190,469,146,201,16,4905,6049
Western State Colorado University,15,59,237,14,21,74,2164,2584
Western Washington University,65,224,1095,28,971,1164,11513,15060
Wheeling Jesuit University,4,70,31,2,19,25,1424,1575
Whitman College,5,14,117,0,80,85,1197,1498
Whitworth University,19,51,205,12,90,133,2144,2654
Wichita State University,118,829,1289,14,940,435,11370,14995
Widener University,17,731,230,6,173,117,3638,4912
Willamette University,33,53,270,9,189,198,2028,2780
William Carey University,17,1096,59,0,119,0,2645,3936
William Jewell College,4,59,36,2,10,60,889,1060
William Paterson University of New Jersey,11,1483,2740,25,704,250,5835,11048
William Penn University,10,290,135,6,24,29,1297,1791
Williams College,3,147,243,0,223,146,1364,2126
Winona State University,9,199,208,5,161,176,7926,8684
Winthrop University,23,1650,217,7,71,147,3909,6024
Wisconsin Lutheran College,7,63,56,1,13,26,1013,1179
Wittenberg University,3,127,62,1,24,95,1652,1964
Wofford College,3,125,54,3,47,53,1373,1658
Worcester Polytechnic Institute,5,130,394,0,294,168,5390,6381
Xavier University of Louisiana,4,2088,77,0,384,78,345,2976
Yale University,49,675,939,5,1581,547,8540,12336
Yeshiva University,6,144,199,15,289,29,5666,6348
